Name,Disc. Date,R.A.,Dec.,Total Epochs,Epochs Pre-SN,Epochs Post-SN,First Epoch,Last Epoch,Next Epoch
Aki,2006-06-19,22h16m01.077s,-17d37m22.09s,205,103,102,1023,1190,42
CSS091127:094447+083137,2009-11-27,9h44m47.1s,8d31m37s,3,1,2,1372,450,427
CSS100912:223118+010516,2010-09-12,22h31m18.33s,1d05m16s,2,1,1,2209,395,395
Caleb,2005-12-12,14h32m28.748s,33d32m10.05s,39,13,26,203,503,123
Cayanne,2004-08-27,12h37m27.11s,62d12m07.68s,213,121,92,214,2385,233
ESSENCEf123,2003-12-01,2h09m57.282s,-3d32m26.609s,13,2,11,9,2563,1084
ESSENCEg097,2004-10-05,23h27m37.16s,-9d35m21s,23,6,17,407,2181,357
ESSENCEg133,2004-09-18,2h09m49.63s,-4d10m55.1s,46,2,44,301,2271,792
ESSENCEg142,2004-10-09,23h28m37.7s,-8d45m04s,16,4,12,35,2177,353
ESSENCEg225,2004-10-17,23h27m15.69s,-9d27m59.8s,17,2,15,419,2169,729
ESSENCEg230,2004-10-17,1h11m56.31s,0d07m27.7s,19,2,17,376,2532,1081
ESSENCEg240,2004-10-13,23h30m41.83s,-8d34m11s,16,4,12,39,2173,349
ESSENCEk411,2004-11-16,23h26m11.77s,-8d50m17.5s,22,4,18,73,2139,315
ESSENCEm022,2005-09-26,23h30m02.7s,-8d33m36.6s,22,6,16,708,1825,1
ESSENCEm026,2005-09-26,23h28m39.97s,-9d19m50s,26,4,22,387,1825,1
ESSENCEm027,2005-09-26,1h09m15.01s,0d08m14.8s,14,2,12,720,1870,742
ESSENCEm032,2005-09-25,23h29m35.34s,-9d58m46.3s,21,4,17,386,1826,2
ESSENCEm043,2005-09-26,23h29m51.73s,-8d56m46.1s,16,4,12,387,1825,1
ESSENCEm062,2005-09-25,1h09m52.902s,0d36m19.03s,14,2,12,719,1829,729
ESSENCEm070,2005-09-28,2h33m46.821s,-8d08m26.888s,19,6,13,341,1899,38
ESSENCEm075,2005-09-26,23h24m42.29s,-8d29m08.7s,16,2,14,708,2209,360
ESSENCEm087,2004-12-15,2h33m37.004s,-8d27m32.462s,4,3,1,54,325,325
ESSENCEm138,2005-10-06,1h08m56.35s,0d39m25.4s,12,4,8,730,1818,718
ESSENCEm158,2005-10-06,23h24m03.53s,-9d23m18.2s,6,1,5,773,1067,375
ESSENCEm226,2005-09-26,2h06m03.69s,-4d39m59.1s,39,1,38,674,1877,1478
ESSENCEn246,2005-11-22,1h14m33.08s,-0d26m23.2s,14,2,12,777,1771,680
ESSENCEn258,2005-11-22,2h06m42.35s,-4d22m37s,43,1,42,731,1844,1421
ESSENCEn263,2005-11-22,2h05m14.95s,-4d56m39.1s,40,2,38,410,1820,1421
ESSENCEn278,2005-11-24,23h28m17.55s,-9d23m12.4s,22,8,14,446,1766,296
ESSENCEn285,2005-11-08,23h23m51.35s,-8d23m18.5s,16,2,14,751,2166,317
ESSENCEn322,2005-11-22,2h29m00.48s,-9d02m53s,20,8,12,396,1835,696
ESSENCEn326,2005-11-24,23h29m58.59s,-8d53m12.5s,16,6,10,446,1766,291
ESSENCEn400,2005-11-26,1h13m13.26s,-0d23m25.9s,16,2,14,781,1767,676
ESSENCEp425,2005-11-24,23h29m56.19s,-8d34m24.3s,20,8,12,767,1766,291
ESSENCEp429,2005-11-24,23h26m02.216s,-8d35m47.978s,20,6,14,446,1766,296
ESSENCEp434,2005-11-24,1h12m40.25s,0d14m56.6s,15,2,13,779,2129,683
ESSENCEp444,2005-11-24,2h06m36.165s,-3d41m33.614s,3,1,2,733,707,360
ESSENCEp445,2005-11-24,1h13m14.547s,0d48m47.659s,28,2,26,423,2129,342
ESSENCEp454,2005-11-24,2h08m32.45s,-3d33m34.2s,13,2,11,733,1839,360
ESSENCEp520,2005-12-24,2h08m09.34s,-3d48m05s,21,2,19,763,1812,330
ESSENCEp527,2005-12-27,2h08m10.47s,-3d32m17.7s,13,2,11,766,1806,327
ESSENCEp528,2005-11-30,2h07m04.66s,-3d28m04.4s,15,2,13,739,1836,354
ESSENCEp534,2005-12-24,2h04m56.09s,-3d49m03.7s,15,2,13,763,1812,330
ESSENCEq002,2006-09-16,2h05m12.945s,-3d39m00.723s,15,2,13,1029,1546,64
ESSENCEq006,2006-09-16,2h10m52.276s,-3d57m39.374s,16,2,14,1029,1543,64
ESSENCEq021,2006-09-16,2h33m43.919s,-8d05m50.05s,17,6,11,694,1546,398
ESSENCEq022,2006-09-11,1h12m03.864s,-0d01m28.9452s,19,2,17,1070,1838,387
ESSENCEr185,2006-10-31,1h11m48.245s,-0d29m49.46s,12,2,10,1120,1428,337
ESSENCEs354,2006-11-26,2h06m10.482s,-5d05m23s,65,2,63,779,1451,1052
ESSENCEs372,2006-12-13,2h08m24.257s,-3d27m32.636s,13,4,9,1117,1455,324
ESSENCEx039,2007-09-17,2h29m18.063s,-7d39m01.433s,15,2,13,301,1181,391
ESSENCEx093,2007-10-08,2h29m43.134s,-9d06m54.931s,21,8,13,1081,1150,11
Eagle,2004-11-06,12h37m20.75s,62d13m41.5s,213,121,92,285,2314,162
Emma,2006-04-22,14h34m30.139s,34d26m57.29s,38,13,25,334,1066,17
Frida,2005-08-07,2h21m42.066s,-3d21m53.12s,76,4,72,265,1923,68
Gabi,2005-04-14,12h36m13.83s,62d12m07.56s,213,121,92,444,2155,3
HST04Man,2004-05-20,12h36m34.853s,62d15m48.86s,211,119,92,112,2484,332
HST04Sas,2004-05-23,12h36m54.125s,62d08m22.21s,213,121,92,118,2481,329
HST05Dic,2005-04-12,12h35m49.61s,62d10m11.96s,211,119,92,439,2157,5
HST05Fer,2005-04-12,12h36m25.1s,62d15m23.84s,211,119,92,439,2157,5
HST05Koe,2005-04-12,12h36m22.92s,62d18m23.2s,211,119,92,439,2157,5
HST05Lan,2005-02-25,12h36m56.72s,62d12m53.33s,213,121,92,396,2203,51
Hawk,2004-11-05,12h35m41.16s,62d11m37.19s,211,119,92,281,2315,163
Jennie,2006-08-18,2h23m00.082s,-4d36m03.04s,54,12,42,641,1547,64
Maggie,2005-10-10,2h21m46.484s,-3d22m56.18s,51,2,49,329,1859,4
McGuire,2004-09-16,3h32m10.02s,-27d49m49.98s,325,78,247,311,2274,401
Naima,2006-08-18,2h20m57.699s,-3d33m23.97s,72,6,66,641,1547,57
PS0909010,2009-09-12,2h28m28.368s,-4d04m44.08s,52,4,48,1030,426,42
PS1-1000004,2010-01-11,3h33m27.948s,-28d22m17.48s,142,131,11,2254,331,314
PS1-1000005,2010-01-12,9h58m59.758s,3d09m27.11s,42,22,20,1438,400,24
PS1-1000007,2010-01-10,2h23m30.711s,-4d38m10.76s,147,136,11,2223,306,289
PS1-1000008,2010-01-10,2h24m15.945s,-3d11m11.53s,54,35,19,1153,306,288
PS1-1000009,2010-01-10,2h20m22.959s,-4d40m21.03s,65,55,10,1903,306,289
PS1-1000790,2010-08-01,21h33m28.573s,10d20m39.54s,7,5,2,743,55,54
PS1-10acx,2010-08-16,16h05m54.089s,55d11m52.3s,63,55,8,2231,298,249
PS1-10bls,2010-11-07,3h32m16.116s,-27d11m39.51s,93,83,10,2554,31,14
PS1-10byr,2010-12-06,22h17m50.801s,1d02m33.8s,127,126,1,2653,310,310
PS1-10byw,2010-11-30,22h15m28.07s,1d32m58.15s,47,46,1,2305,255,255
PS1-10ia,2010-03-20,14h11m31.058s,53d34m46.48s,18,10,8,319,359,2
PS1-10if,2010-03-20,10h00m21.196s,1d25m05.25s,45,34,11,2225,333,2
PS1-10im,2010-04-02,10h50m05.881s,58d46m38.71s,62,60,2,2260,340,341
PS1-10io,2010-04-12,10h00m44.015s,3d24m14.31s,43,34,9,1528,310,294
PS1-10j,2010-01-16,10h49m14.22s,58d28m02.04s,51,48,3,2184,416,5
PS1-10k,2010-01-16,10h00m27.616s,2d41m38.52s,199,162,37,2166,396,19
PS1-10ka,2010-05-16,16h11m10.31s,55d07m20.3s,49,40,9,2511,390,32
PS1-10m,2010-01-16,10h02m09.393s,1d53m57.01s,98,81,17,2166,429,22
PS1-10n,2010-01-16,10h03m14.385s,3d08m39.21s,42,20,22,1418,739,19
PS1-10o,2010-01-18,10h02m08.822s,2d43m06.83s,100,80,20,2168,394,17
PS1-10p,2010-01-20,9h59m16.802s,1d36m48.55s,100,77,23,2170,413,16
PS1-10s,2010-01-16,9h55m57.231s,2d15m48.47s,36,16,20,732,738,20
PS1-11aac,2011-05-24,14h15m17.287s,54d17m56.14s,20,19,1,750,9,10
PS1-11at,2011-01-05,10h01m53.027s,2d02m33.53s,176,160,16,2520,75,27
PS1-11bg,2011-01-11,10h03m58.861s,2d15m44.71s,39,28,11,2129,69,21
PS1-11bk,2011-01-11,9h56m19.761s,1d24m34.08s,38,29,9,2129,36,21
PS1-11fi,2011-02-05,14h12m57.07s,52d44m37.19s,20,18,2,641,37,36
PS1-11kk,2011-02-10,16h10m49.277s,55d15m05.31s,50,42,8,2781,120,71
PS1-11kl,2011-02-10,16h21m20.254s,55d00m19.76s,40,32,8,2401,120,71
PS1-11uw,2011-04-24,16h04m56.287s,54d52m41.3s,83,71,12,2482,47,2
PS1-11w,2011-01-05,10h54m43.784s,58d37m35.62s,87,85,2,2538,62,63
PS1-11yj,2011-05-24,16h08m30.469s,53d41m07.17s,44,42,2,2567,17,14
PS1-11yu,2011-05-24,16h12m46.179s,54d52m25.4s,49,47,2,2884,17,13
PS1-11zu,2011-05-27,16h06m28.184s,53d52m18.49s,43,41,2,2570,14,11
PS1-11zv,2011-05-27,16h11m37.152s,53d58m12.96s,43,41,2,2570,14,11
PS1-11zw,2011-05-27,16h10m25.814s,54d08m58.48s,44,42,2,2570,14,11
PS1-12sf,2009-12-23,10h06m15.919s,2d24m24.74s,13,10,3,1745,763,453
PS1-13lo,2010-02-16,9h59m12.104s,3d13m17.64s,40,26,14,1473,365,6
PSc000022,2010-01-03,2h24m34.669s,-4d23m41.75s,200,190,10,2259,313,298
PSc000200,2010-01-08,10h02m31.517s,2d42m04.5s,96,76,20,2158,404,27
PSc000210,2010-01-08,9h57m52.693s,3d00m30.82s,49,28,21,1434,746,28
PSc000418,2010-01-08,9h58m25.701s,1d41m39s,105,82,23,2158,425,28
PSc000552,2010-01-16,10h00m26.58s,2d28m59.67s,179,160,19,2166,396,20
PSc010014,2010-01-21,10h01m54.194s,1d09m07.1s,49,25,24,1774,391,15
PSc010055,2010-02-04,10h05m02.987s,1d57m53.74s,40,17,23,1788,410,1
PSc010218,2010-02-09,9h54m32.47s,1d56m37.52s,33,17,16,756,372,1
PSc020047,2010-03-09,9h56m56.438s,1d36m49.8s,38,29,9,1821,344,329
PSc020104,2010-03-09,9h58m36.773s,2d17m37.7s,176,165,11,2218,365,329
PSc020194,2010-03-12,9h58m34.81s,0d49m52.09s,41,31,10,1824,373,326
PSc030007,2010-03-25,14h09m23.651s,53d37m06.96s,18,12,6,324,354,32
PSc030216,2010-04-12,14h14m56.573s,54d12m41.36s,18,12,6,342,336,14
PSc040121,2010-04-12,10h39m04.002s,58d35m25.74s,25,24,1,1912,277,277
PSc040139,2010-05-06,14h17m09.899s,53d05m11.39s,245,239,6,2512,392,311
PSc040147,2010-04-17,14h15m40.447s,54d13m43.84s,20,13,7,348,411,9
PSc040169,2010-05-10,10h49m29.312s,58d45m59.04s,51,49,2,2298,302,303
PSc040316,2010-05-10,14h11m23.481s,52d26m04.6s,20,18,2,370,308,307
PSc040318,2010-05-09,14h17m19.798s,53d06m45.28s,246,240,6,2515,389,308
PSc040477,2010-05-08,16h20m34.011s,54d48m24.17s,40,28,12,2123,398,2
PSc040511,2010-05-13,16h07m40.019s,55d07m29.93s,83,71,12,2191,393,36
PSc040512,2010-05-10,16h08m01.032s,54d13m24.24s,67,50,17,2188,396,39
PSc040540,2010-05-10,14h08m37.451s,52d39m37.15s,20,18,2,370,308,307
PSc040693,2010-05-16,14h15m27.863s,52d23m50.02s,19,17,2,376,302,301
PSc040783,2010-05-21,16h11m06.899s,54d49m49.74s,49,40,9,2516,385,27
PSc050004,2010-05-16,14h10m49.486s,53d50m17.45s,18,16,2,376,302,301
PSc050298,2010-05-14,16h12m38.024s,55d43m14.67s,24,14,10,369,392,37
PSc050617,2010-06-15,14h18m25.922s,53d54m43.07s,4,3,1,357,272,273
PSc050625,2010-06-15,16h07m18.197s,53d49m47.77s,43,34,9,2224,360,3
PSc050656,2010-06-15,16h16m50.373s,54d38m46.73s,46,36,10,2540,360,3
PSc050665,2010-06-05,16h10m34.502s,54d57m25.53s,49,40,9,2531,370,12
PSc051109,2010-04-09,16h12m11.536s,54d00m32.46s,52,38,14,2157,427,25
PSc052136,2010-06-13,14h12m54.447s,52d47m32.5s,20,18,2,404,274,273
PSc060015,2010-06-29,16h03m50.262s,54d12m36.57s,46,38,8,2238,346,297
PSc060141,2010-07-01,16h09m39.092s,54d16m08.94s,47,39,8,2240,344,295
PSc060199,2010-07-11,14h09m39.159s,53d38m35.01s,18,16,2,432,246,245
PSc060238,2010-07-11,22h14m42.32s,0d47m51.7s,67,48,19,2492,397,21
PSc060242,2010-07-11,14h12m36.512s,54d02m59.78s,24,23,1,432,246,247
PSc060249,2010-07-11,22h19m51.403s,0d53m51.82s,4,1,3,329,458,28
PSc061190,2010-07-30,2h22m43.622s,-4d57m11.44s,50,38,12,2083,105,88
PSc061191,2010-07-29,2h25m06.486s,-5d00m03.06s,121,111,10,2423,106,89
PSc061192,2010-07-29,2h20m30.796s,-4d59m51.58s,49,39,10,2103,106,89
PSc061197,2010-07-29,2h21m54.589s,-4d11m18.99s,74,56,18,2082,106,89
PSc070003,2010-07-31,22h12m09.952s,0d43m09.41s,42,34,8,2184,22,6
PSc070048,2010-05-22,16h04m04.105s,54d11m55.5s,57,49,8,2200,384,335
PSc070054,2010-08-03,16h11m45.287s,55d17m56.99s,48,40,8,2590,311,262
PSc070071,2010-08-02,22h19m56.442s,-0d26m30.92s,38,28,10,711,436,5
PSc070096,2010-08-03,16h12m31.207s,53d48m33.16s,43,35,8,2273,311,262
PSc070111,2010-07-29,2h25m34.355s,-5d13m07.13s,49,38,11,2082,139,89
PSc070175,2010-08-03,16h07m36.818s,54d48m35.15s,44,36,8,2273,311,262
PSc070200,2010-07-30,2h26m38.462s,-3d36m57.83s,49,40,9,2440,105,87
PSc070264,2010-08-04,22h13m47.572s,0d26m28.25s,44,34,10,2188,33,3
PSc070459,2010-08-07,22h12m43.607s,0d36m42.44s,80,64,16,2191,30,1
PSc070470,2010-08-05,2h19m48.006s,-3d42m10.47s,50,42,8,2448,99,81
PSc070530,2010-07-29,2h25m09.816s,-5d02m36.26s,62,51,11,2422,139,89
PSc070567,2010-08-14,22h13m18.456s,0d48m46.22s,11,9,2,2198,23,4
PSc070611,2010-08-15,16h18m08.915s,53d58m19.13s,42,34,8,1933,299,250
PSc071007,2010-08-20,22h15m37.447s,1d15m38.93s,47,42,5,2203,357,0
PSc071011,2010-08-14,22h12m49.28s,-0d42m25.59s,47,42,5,2198,45,1
PSc071032,2010-08-29,22h19m13.268s,0d52m25.93s,126,121,5,2554,409,6
PSc071113,2010-08-29,16h11m44.234s,55d08m51.76s,49,41,8,2616,285,236
PSc071245,2010-08-28,22h15m02.874s,-0d51m54.61s,43,40,3,1433,31,8
PSc080012,2010-08-20,22h14m08.482s,-0d10m06.88s,44,40,4,1425,39,1
PSc080034,2010-08-17,22h15m24.782s,0d32m10.68s,48,42,6,2529,367,2
PSc080048,2010-08-27,2h24m25.254s,-5d00m44.34s,28,18,10,2106,77,60
PSc080064,2010-09-03,3h29m42.071s,-27d52m38.11s,58,47,11,2489,96,78
PSc080146,2010-09-02,3h31m19.116s,-26d51m52.43s,92,82,10,1769,97,80
PSc080241,2010-09-02,3h28m32.442s,-28d04m17.73s,56,46,10,2464,97,79
PSc080252,2010-09-02,2h24m41.569s,-3d47m00.06s,69,55,14,2474,71,53
PSc080257,2010-09-02,3h37m43.957s,-27d19m15.26s,60,50,10,2460,97,80
PSc080261,2010-08-31,3h35m11.954s,-27d11m47.17s,63,52,11,2458,99,82
PSc080295,2010-09-02,2h24m43.481s,-4d09m34.94s,129,119,10,2476,71,56
PSc080296,2010-08-27,2h21m49.682s,-3d55m16.97s,49,31,18,1382,77,59
PSc080343,2010-08-31,3h37m28.646s,-27d43m23.52s,60,50,10,2458,99,82
PSc080363,2009-09-15,3h26m38.821s,-27d55m14.34s,56,27,29,2112,449,49
PSc080438,2010-09-08,3h31m44.958s,-27d40m58.79s,220,125,95,2494,91,73
PSc080554,2010-09-03,2h21m00.039s,-3d40m18.75s,44,35,9,2118,70,52
PSc080646,2010-09-10,22h18m29.334s,0d56m29.35s,127,126,1,2566,397,397
PSc080723,2010-09-29,2h19m56.728s,-3d57m38.18s,49,40,9,2166,44,26
PSc080735,2010-09-29,22h15m29.67s,0d32m30.87s,77,76,1,2572,324,324
PSc080771,2010-09-13,3h28m16.421s,-28d08m49.41s,56,46,10,2475,86,68
PSc080772,2010-09-16,3h31m35.901s,-28d14m27.1s,212,110,102,2502,83,65
PSc090107,2010-09-27,2h22m57.885s,-4d18m40.25s,56,46,10,2473,46,29
PSc090128,2010-10-07,2h24m04.603s,-3d13m33.83s,53,34,19,1423,36,18
PSc090130,2010-09-16,3h34m26.099s,-26d35m34.49s,62,52,10,1740,83,66
PSc090147,2010-10-07,2h26m05.502s,-5d29m39.51s,47,38,9,2152,69,21
PSc090196,2010-10-06,2h19m24.164s,-4d35m03.99s,66,30,36,2172,64,22
PSc090275,2010-10-13,3h36m17.301s,-28d03m05.44s,69,59,10,1766,56,39
PSc090966,2010-10-13,22h12m56.579s,1d01m50.48s,51,50,1,2257,303,303
PSc091739,2010-10-13,2h27m58.329s,-4d01m29.39s,38,28,10,2541,30,13
PSc091748,2010-10-31,3h28m29.494s,-26d49m42.58s,61,51,10,1785,38,21
PSc100163,2010-11-10,2h21m46.162s,-5d09m05.76s,93,91,2,2207,2,1
PSc100164,2010-10-29,2h21m28.917s,-5d01m34.02s,93,84,9,2195,14,1
PSc100206,2010-11-07,3h30m04.362s,-28d15m24.09s,55,46,9,2530,31,13
PSc100405,2010-11-24,3h34m30.852s,-27d19m14.09s,63,55,8,2543,14,1
PSc110014,2010-11-07,22h18m27.834s,-0d09m45.94s,39,38,1,808,339,340
PSc110476,2010-12-15,10h05m18.648s,2d04m58.9s,38,28,10,2102,96,48
PSc110725,2009-12-27,8h41m03.877s,44d29m11.67s,8,7,1,2171,18,19
PSc120039,2010-12-30,9h56m26.084s,1d32m06.38s,38,29,9,2117,48,33
PSc120111,2010-12-30,10h00m53.74s,2d31m18.9s,176,166,10,2514,48,33
PSc120223,2011-01-02,9h59m02.791s,3d07m38.38s,42,33,9,1793,45,29
PSc120313,2010-12-30,10h03m30.71s,2d52m04.85s,38,27,11,1766,391,32
PSc120458,2011-01-09,9h58m06.695s,1d55m49.38s,96,86,10,2524,59,23
PSc120706,2011-01-15,9h58m43.172s,2d25m59.47s,180,169,11,2530,53,17
PSc130145,2011-01-15,9h59m49.558s,3d28m44.09s,37,29,8,1806,32,16
PSc130373,2011-02-04,14h18m20.292s,53d38m39.14s,18,16,2,640,38,37
PSc130391,2011-02-02,14h11m41.445s,54d13m17.56s,18,17,1,638,40,41
PSc131031,2011-02-10,14h09m41.539s,53d20m58.92s,19,17,2,646,32,31
PSc140164,2011-03-09,10h05m33.961s,2d01m20.13s,38,37,1,2186,12,13
PSc140210,2011-03-09,14h15m04.186s,53d27m17.28s,18,16,2,673,5,4
PSc140214,2011-03-09,14h14m13.815s,53d42m06.94s,18,16,2,673,5,4
PSc140229,2011-03-12,12h26m44.345s,47d23m28.88s,17,16,1,2199,88,88
PSc140234,2011-03-09,14h08m46.699s,53d49m25.19s,18,16,2,673,5,4
PSc150145,2009-05-01,12h28m21.218s,47d17m18.8s,8,7,1,1519,768,768
PSc150210,2011-03-31,9h58m16.059s,2d30m57.57s,163,162,1,2605,299,300
PSc150234,2009-06-17,14h11m04.974s,52d36m19.61s,20,4,16,43,635,0
PSc150365,2011-04-21,16h10m03.587s,53d49m02.98s,46,38,8,2534,50,1
PSc150379,2011-04-21,16h04m10.001s,53d58m23.75s,59,51,8,2534,50,1
PSc150515,2011-04-21,16h04m37.768s,55d16m08.12s,46,38,8,2180,50,1
PSc151005,2010-02-25,14h09m15.562s,52d23m01.74s,20,8,12,296,382,17
PSc160028,2011-05-12,16h13m23.246s,53d58m16.75s,72,66,6,2555,29,0
PSc160195,2011-05-27,16h10m40.306s,53d39m26.32s,41,39,2,2515,14,11
PSc160262,2009-06-11,16h18m39.19s,55d42m21.73s,42,22,20,1500,729,10
PSc170178,2010-02-25,14h12m42.377s,53d31m11.74s,18,7,11,296,382,19
PSc170254,2011-05-30,16h08m54.049s,53d51m22.45s,43,41,2,2573,11,8
PSc170285,2011-05-30,16h16m09.313s,54d08m30.04s,62,60,2,2573,11,8
PSc170324,2011-05-29,16h18m05.315s,55d34m07.51s,57,55,2,2509,12,8
PSc170539,2011-06-26,22h17m54.529s,1d22m41.5s,4,3,1,1421,108,108
PSc170558,2011-06-26,22h18m45.773s,1d21m55.85s,3,2,1,675,108,108
PSc180255,2011-07-01,22h14m56.395s,0d32m39.24s,49,48,1,2847,49,49
PSc180329,2011-07-12,22h17m20.245s,1d15m31.9s,10,9,1,2858,92,92
PSc180424,2011-07-25,22h17m20.279s,0d31m57.37s,134,133,1,2884,25,25
PSc180561,2011-07-28,22h17m50.984s,1d28m06.39s,2,1,1,674,76,76
PSc190062,2011-07-31,22h15m25.461s,0d40m47.77s,72,70,2,2877,19,12
PSc190230,2011-08-18,22h15m44.873s,0d25m21.14s,154,153,1,2908,1,1
PSc190269,2011-08-19,22h20m04.279s,-0d14m15s,38,37,1,1093,54,55
PSc200058,2011-09-06,22h17m58.874s,-0d26m28.32s,40,39,1,1111,36,37
PSc200132,2011-09-19,22h17m58.556s,-0d41m48.81s,5,4,1,747,23,24
PSc200170,2011-09-25,22h17m44.37s,1d21m00.72s,5,4,1,1512,17,17
PSc210027,2011-09-30,22h17m11.892s,1d04m34.96s,131,130,1,2951,12,12
PSc340105,2010-09-12,2h23m52.675s,-3d38m04s,47,38,9,2484,61,43
PSc350213,2012-01-24,10h04m06.984s,2d43m56.99s,43,42,1,2156,1,1
PSc370589,2011-02-03,9h56m25.97s,3d27m17.1s,41,31,10,1825,355,2
PSc380095,2010-02-25,14h08m51.157s,53d35m38.3s,18,7,11,296,382,19
PSc380204,2009-06-02,14h15m14.266s,53d05m16.23s,23,6,17,28,650,18
PSc380421,2010-05-14,14h07m27.685s,54d00m38.93s,19,17,2,2520,304,303
PSc480635,2010-04-04,9h59m56.024s,2d33m33.52s,178,169,9,2244,318,303
PSc500020,2010-03-09,14h13m42.163s,52d28m14.71s,30,11,19,308,370,5
PSc500043,2011-01-11,9h59m44.791s,2d18m08.08s,292,281,11,2526,57,21
PSc500065,2010-05-09,14h16m21.03s,54d08m05.62s,18,16,2,369,309,308
PSc520011,2010-04-19,14h19m17.434s,52d28m43.5s,253,237,16,2495,409,6
PSc550031,2009-09-16,2h25m20.926s,-5d19m18.51s,49,24,25,1766,455,41
PSc580006,2010-09-03,2h20m37.941s,-4d38m31.28s,70,60,10,2139,70,53
PSc580010,2009-12-21,2h26m56.021s,-3d44m34.31s,50,40,10,2219,326,308
PSc580024,2009-12-05,2h22m33.802s,-5d27m55.11s,28,25,3,1846,328,17
PSc580072,2009-12-21,10h00m07.829s,2d01m25s,293,272,21,2140,443,46
PSc590191,2010-03-09,10h00m33.072s,1d54m14.41s,162,151,11,2218,365,329
PTF09djc,2009-08-10,17h46m55.9s,59d12m04.86s,3,2,1,1068,723,724
PTF09foz,2009-10-09,0h42m11.893s,-9d52m54.65s,32,3,29,1095,706,344
PTF10cko,2010-02-24,12h11m15.37s,13d44m01.5s,3,2,1,2145,26,27
PTF10feg,2010-03-20,12h30m35.68s,15d47m38.9s,9,2,7,1068,38,11
PTF10fej,2010-03-25,16h06m19.32s,53d55m16.8s,62,43,19,2142,442,40
PTF10fxe,2010-04-25,9h45m09.71s,22d37m44s,3,1,2,1183,296,296
PTF10goq,2010-04-30,12h45m59.66s,4d49m29s,5,3,2,2211,338,3
PTF10gsp,2010-04-27,13h53m35.97s,39d58m22.2s,5,3,2,1783,315,315
PTF10hdm,2010-05-03,12h42m41.04s,5d11m07.1s,7,4,3,2214,335,335
PTF10mtd,2010-06-24,14h01m59.62s,4d59m05.2s,37,36,1,2234,293,294
PTF10nda,2010-06-27,13h57m09.73s,61d15m09.1s,5,3,2,1939,295,250
PTF10nvh,2010-06-23,21h32m02.35s,8d59m35.7s,3,2,1,2139,408,408
PTF10qna,2010-08-02,0h47m50.83s,-25d57m56.4s,5,4,1,2476,397,398
PTF10rbp,2010-08-08,1h16m37.78s,-1d49m28.2s,2,1,1,670,446,447
PTF10rgn,2010-08-07,1h41m40.27s,30d49m26.9s,3,2,1,2132,108,109
PTF10tqy,2010-08-31,0h42m41.52s,24d45m14.2s,4,3,1,1392,418,419
PTF10trp,2010-08-27,21h28m08.01s,9d51m14s,13,10,3,2248,343,28
PTF10ujt,2010-09-01,1h49m34.34s,-8d48m02.5s,5,4,1,2524,405,405
PTF10vnu,2010-09-16,1h11m03.36s,0d26m27.4s,8,3,5,2536,53,11
PTF10vyv,2010-09-21,1h40m01.08s,-8d02m42.5s,3,2,1,2504,388,388
PTF10wnt,2010-09-21,1h42m10.01s,-8d47m39.1s,6,5,1,2533,388,388
PTF10xgp,2010-10-03,4h16m50.3s,1d51m39.2s,5,2,3,1720,439,80
PTF10xhs,2010-09-30,0h03m05.53s,12d08m02.5s,2,1,1,2229,392,392
PTF11dej,2011-05-04,14h15m54.34s,30d22m09.9s,5,3,2,2171,31,19
PTF11fvq,2011-06-12,0h37m39.81s,40d40m43.3s,69,62,7,1677,61,56
PTF11gdm,2011-06-21,16h56m23.7s,41d30m15.1s,4,3,1,2591,24,25
PTF11hfu,2011-07-08,21h21m13.83s,2d19m11.9s,7,5,2,1453,27,23
PTF11ilj,2011-07-21,0h35m44.05s,38d40m06.6s,3,1,2,2081,63,16
PTF11kjl,2011-08-11,17h24m42.68s,73d20m59.3s,2,1,1,1635,40,40
PTF11paw,2011-10-21,0h39m02.06s,42d01m04.6s,49,48,1,2934,2,2
PTF11pdl,2011-10-21,0h49m15.81s,40d02m59.6s,3,2,1,2173,18,18
PTF11phm,2011-10-25,2h01m42.59s,27d45m21s,4,3,1,1833,28,28
PTF11wv,2011-01-24,9h54m56.13s,4d07m41.5s,6,2,4,1815,365,55
Patuxent,2004-07-09,12h38m08.961s,62d18m47.39s,211,119,92,162,2434,282
Rakke,2004-12-16,3h32m18.15s,-27d44m10.55s,327,78,249,402,2183,310
SCP-06H3,2006-04-04,14h34m28.879s,34d27m26.61s,39,12,27,316,1084,10
SDSS-II SN 10036,2005-11-03,1h35m27.336s,0d13m57.018s,8,4,4,395,1078,702
SDSS-II SN 10066,2005-11-03,21h36m00.72s,-0d03m14.868s,146,70,76,88,1779,276
SDSS-II SN 10113,2005-11-01,3h36m43.628s,-0d08m25.2s,11,2,9,705,1492,404
SDSS-II SN 10146,2005-10-20,1h43m07.008s,1d15m04.824s,8,4,4,381,1093,717
SDSS-II SN 10154,2005-10-30,2h06m46.008s,1d15m01.476s,8,6,2,744,1078,1079
SDSS-II SN 10299,2005-11-05,22h49m03.36s,0d59m36.89s,10,8,2,452,1068,1069
SDSS-II SN 10450,2005-11-02,22h29m06.24s,-1d07m43.212s,21,6,15,448,2170,267
SDSS-II SN 10506,2005-10-26,0h48m06.384s,0d30m00.648s,8,2,6,752,738,710
SDSS-II SN 10524,2005-11-02,3h43m55.944s,0d35m04.7508s,4,2,2,702,1129,1129
SDSS-II SN 10559,2005-11-02,23h36m27.968s,-1d13m35.53s,10,4,6,750,686,325
SDSS-II SN 10620,2005-10-25,23h49m57.12s,-0d25m13.4364s,12,2,10,737,1037,339
SDSS-II SN 11026,2005-10-21,21h43m13.68s,0d53m27.928s,8,4,4,782,1053,1053
SDSS-II SN 11098,2005-11-19,20h38m32.88s,1d12m31.284s,21,6,15,495,1688,257
SDSS-II SN 11156,2005-11-12,1h36m22.512s,-0d52m17.9328s,8,4,4,404,1069,693
SDSS-II SN 11181,2005-11-19,23h48m05.183s,-0d08m35.74s,6,2,4,762,1012,314
SDSS-II SN 11305,2005-11-12,1h58m04.656s,-0d34m16.662s,8,4,4,403,1073,1074
SDSS-II SN 11317,2005-11-10,3h46m01.728s,0d33m43.6s,8,2,6,710,1129,1123
SDSS-II SN 11370,2005-11-02,0h45m52.104s,-0d42m50.274s,12,2,10,759,704,691
SDSS-II SN 11518,2005-11-23,0h33m38.3712s,0d32m18.409s,12,2,10,784,669,341
SDSS-II SN 11523,2005-11-07,0h37m55.5288s,0d36m05.8536s,12,4,8,373,1039,670
SDSS-II SN 1158,2005-09-09,1h09m06.096s,-0d21m07.866s,10,2,8,703,1887,758
SDSS-II SN 1166,2005-09-09,0h37m25.35s,0d58m23.8s,16,6,10,709,1098,753
SDSS-II SN 11771,2005-11-19,1h00m55.35s,-0d31m33.53s,10,2,8,774,708,687
SDSS-II SN 11858,2005-11-19,0h04m12.396s,0d21m34.13s,16,2,14,760,718,681
SDSS-II SN 12076,2005-11-19,2h00m31.752s,-0d57m13.9176s,8,4,4,410,1067,1067
SDSS-II SN 12199,2005-11-23,23h16m39.626s,-1d09m29.61s,8,4,4,821,1050,308
SDSS-II SN 12213,2005-11-07,23h02m20.18s,-0d38m46.9s,15,9,6,768,1066,340
SDSS-II SN 12804,2006-08-28,1h12m48.408s,1d02m24.61s,21,2,19,700,1492,65
SDSS-II SN 1282,2005-09-12,21h19m51.84s,0d30m40.806s,9,6,3,394,1099,1
SDSS-II SN 12852,2006-08-27,20h57m00.73s,0d41m20.9s,7,6,1,1098,1055,1055
SDSS-II SN 12875,2006-08-27,23h48m30.48s,-0d03m43.8588s,16,2,14,1043,739,19
SDSS-II SN 12879,2006-08-27,0h29m47.807s,-0d09m43.09s,10,4,6,1057,392,392
SDSS-II SN 12924,2006-09-11,1h08m45.768s,0d44m00.5532s,24,8,16,1070,1478,378
SDSS-II SN 12936,2006-08-28,2h08m10.91s,-1d03m05.4s,8,6,2,1047,782,782
SDSS-II SN 12941,2006-08-27,23h47m07.2s,-0d35m57.0228s,6,2,4,1043,731,33
SDSS-II SN 12947,2006-09-11,20h21m21.17s,-0d35m31.8s,2,1,1,8,314,315
SDSS-II SN 12974,2006-08-28,1h26m34.032s,-0d13m42.0096s,14,4,10,701,759,403
SDSS-II SN 12978,2006-08-28,0h28m40.119s,0d08m52.52s,8,2,6,705,761,404
SDSS-II SN 13009,2006-08-28,0h45m54.048s,0d31m28.715s,8,2,6,1058,432,404
SDSS-II SN 1302,2005-09-09,3h34m37.152s,0d53m30.851s,4,2,2,652,1180,1180
SDSS-II SN 13066,2006-08-28,23h04m31.2s,-1d15m05.076s,15,9,6,1062,772,46
SDSS-II SN 13076,2006-08-28,22h53m34.08s,0d11m17.05s,14,8,6,746,772,16
SDSS-II SN 13079,2006-08-28,0h05m09.6648s,0d10m04.0332s,10,2,8,1042,436,400
SDSS-II SN 13096,2006-09-15,23h53m28.8s,-1d12m08.1s,12,2,10,1062,422,37
SDSS-II SN 13101,2006-09-12,0h06m24.54s,-1d13m54.6s,6,4,2,1100,421,422
SDSS-II SN 13108,2006-09-16,0h39m28.989s,-1d12m01.16s,10,2,8,1064,407,385
SDSS-II SN 13147,2006-08-28,23h52m46.49s,0d05m21.9s,8,2,6,1042,738,56
SDSS-II SN 13168,2006-09-12,0h06m24.384s,0d37m17.2s,10,2,8,1057,421,385
SDSS-II SN 13177,2006-09-12,1h26m25.752s,0d33m52.934s,6,4,2,716,385,386
SDSS-II SN 13302,2006-09-11,21h54m48s,-0d30m05.3568s,12,2,10,19,724,1
SDSS-II SN 13303,2006-09-11,21h59m11.52s,-0d26m09.8772s,14,2,12,19,711,1
SDSS-II SN 13333,2006-09-11,21h14m35.76s,0d16m41.459s,10,6,4,758,1035,736
SDSS-II SN 13336,2006-09-11,21h29m54.24s,0d13m14.819s,610,241,369,1117,1467,317
SDSS-II SN 13339,2006-09-11,21h44m20.88s,0d18m17.284s,6,4,2,1107,728,728
SDSS-II SN 13378,2006-09-11,2h26m10.224s,1d08m47.184s,8,4,4,1022,773,773
SDSS-II SN 13393,2006-09-15,22h52m57.12s,0d37m03s,14,10,4,764,754,23
SDSS-II SN 13411,2006-08-28,21h00m45.6s,0d11m30.17s,14,7,7,1099,1054,736
SDSS-II SN 1342,2005-09-09,23h06m06.605s,0d07m01.24s,7,5,2,686,1126,1127
SDSS-II SN 13452,2006-09-15,0h07m40.994s,-0d21m04.54s,12,2,10,1060,744,382
SDSS-II SN 13458,2006-09-16,1h05m51.198s,-0d15m01.69s,14,2,12,1075,407,386
SDSS-II SN 13465,2006-09-15,23h15m31.92s,0d00m58.2s,18,6,12,1117,1106,18
SDSS-II SN 13476,2006-09-15,23h44m04.008s,-0d47m27.44s,10,2,8,0,714,12
SDSS-II SN 13479,2006-09-16,2h25m53.304s,-0d22m17.562s,13,5,8,691,759,397
SDSS-II SN 13492,2006-09-11,3h23m38.304s,0d12m36.781s,6,2,4,1021,825,825
SDSS-II SN 13494,2006-09-16,3h33m19.008s,0d12m04.5576s,6,2,4,1024,808,466
SDSS-II SN 13497,2006-09-12,1h43m44.371s,-1d02m45.44s,8,6,2,1062,760,761
SDSS-II SN 13507,2006-09-12,1h41m49.584s,-0d47m44.412s,12,6,6,1062,765,378
SDSS-II SN 13520,2006-09-11,1h08m42.082s,-0d00m57.27s,10,2,8,1070,1520,391
SDSS-II SN 13529,2006-09-11,1h26m52.812s,0d20m12.45s,6,4,2,715,388,389
SDSS-II SN 13532,2006-09-12,0h37m08.664s,0d34m41.077s,14,2,12,1077,384,48
SDSS-II SN 13558,2006-09-16,1h01m21.816s,1d00m38.736s,4,2,2,1075,420,421
SDSS-II SN 13590,2006-09-11,21h54m40.32s,-0d06m25.848s,12,2,10,19,724,1
SDSS-II SN 13615,2006-09-17,20h45m38.99s,1d11m12.12s,64,10,54,797,1386,674
SDSS-II SN 13617,2006-09-11,21h13m19.68s,1d13m30.54s,3,1,2,758,730,726
SDSS-II SN 13646,2006-09-11,23h49m53.417s,-1d01m55.61s,10,6,4,1114,403,359
SDSS-II SN 13716,2006-09-18,20h59m48.96s,0d29m18.539s,5,4,1,1120,1033,1033
SDSS-II SN 13729,2006-09-18,21h15m40.497s,0d52m31s,14,6,8,765,1035,720
SDSS-II SN 13731,2006-09-18,21h27m09.6s,0d58m44.216s,22,4,18,2,1781,310
SDSS-II SN 13732,2006-09-18,21h37m04.32s,0d54m03.726s,22,8,14,1114,721,300
SDSS-II SN 13734,2006-09-15,21h59m21.12s,1d00m38.196s,13,8,5,769,1092,734
SDSS-II SN 13737,2006-09-15,22h35m42.312s,0d57m45.67s,2,1,1,751,1853,1853
SDSS-II SN 13777,2006-09-15,23h06m34.72s,-0d41m03.43s,12,6,6,1118,755,28
SDSS-II SN 1378,2005-09-09,1h42m35.784s,-1d12m47.412s,8,6,2,694,1128,1129
SDSS-II SN 13786,2006-09-16,0h38m20.2656s,-0d45m16.002s,22,2,20,1064,420,357
SDSS-II SN 13807,2006-09-16,0h42m23.98s,0d26m54s,14,2,12,1077,406,357
SDSS-II SN 13813,2006-09-18,21h13m17.008s,-0d24m17.07s,14,4,10,2,1040,692
SDSS-II SN 13833,2006-09-11,23h37m17.172s,-0d12m33.59s,12,4,8,1063,374,12
SDSS-II SN 13834,2006-08-28,23h55m01.68s,-0d13m23.1816s,10,2,8,1042,438,57
SDSS-II SN 13836,2006-09-12,0h27m39.228s,-0d21m47.682s,10,4,6,1073,376,376
SDSS-II SN 13839,2006-09-16,20h41m20.64s,0d10m41.855s,14,6,8,796,1387,675
SDSS-II SN 13843,2006-09-17,21h16m38.48s,0d12m25.8s,15,6,9,764,1090,723
SDSS-II SN 1385,2005-09-09,0h35m18.514s,0d04m33.19s,12,2,10,709,744,416
SDSS-II SN 13859,2006-09-16,0h44m14.924s,0d58m01.34s,14,2,12,1077,406,357
SDSS-II SN 13864,2006-09-15,23h14m17.784s,0d11m27.83s,6,4,2,1117,755,756
SDSS-II SN 13867,2006-09-18,23h25m49.177s,0d01m46.06s,105,70,35,1119,1135,0
SDSS-II SN 13896,2006-09-19,0h10m51.087s,-0d04m11.42s,22,2,20,1064,764,381
SDSS-II SN 13901,2006-09-17,1h27m41.053s,-0d08m40.65s,12,4,8,721,739,383
SDSS-II SN 13902,2006-09-11,23h15m53.411s,0d15m08.6s,12,4,8,1112,1110,22
SDSS-II SN 13903,2006-09-11,23h59m12.24s,0d15m06.4692s,8,2,6,1056,424,42
SDSS-II SN 13904,2006-09-19,0h27m26.35s,0d17m01s,12,2,10,727,739,382
SDSS-II SN 13907,2006-10-01,0h56m43.041s,0d13m57.21s,12,2,10,1090,393,359
SDSS-II SN 13908,2006-09-17,1h03m39.786s,0d17m42.71s,10,2,8,1076,406,385
SDSS-II SN 13909,2006-09-17,1h05m40.87s,0d18m43.3s,8,2,6,1076,406,385
SDSS-II SN 13931,2006-09-11,1h51m52.512s,-1d02m13.272s,10,4,6,707,770,770
SDSS-II SN 13942,2006-09-11,1h55m17.904s,-0d34m55.452s,16,4,12,706,1550,770
SDSS-II SN 13946,2006-09-17,2h13m55.2s,-0d28m57.1908s,6,2,4,1028,767,768
SDSS-II SN 13958,2006-09-17,1h27m09.06s,0d48m01.3s,6,4,2,721,380,381
SDSS-II SN 13998,2006-10-11,21h36m18.24s,-0d01m31.5444s,173,76,97,430,1437,277
SDSS-II SN 1403,2005-09-09,23h58m48.919s,0d25m55.04s,6,2,4,689,791,409
SDSS-II SN 14035,2006-10-04,23h19m52.08s,-0d16m41.6748s,6,4,2,1135,737,737
SDSS-II SN 14043,2006-09-20,0h19m14.0616s,-0d14m11.778s,18,4,14,728,740,38
SDSS-II SN 14046,2006-11-11,23h24m46.08s,0d11m00.8s,136,103,33,1173,1079,295
SDSS-II SN 14074,2006-09-27,22h48m30.245s,-0d49m30.84s,9,2,7,14,1771,11
SDSS-II SN 14087,2006-09-16,0h23m09.564s,-0d39m55.1304s,10,4,6,1077,409,385
SDSS-II SN 14090,2006-09-16,0h46m38.688s,-0d44m03.894s,12,2,10,1077,386,373
SDSS-II SN 14093,2006-09-17,1h46m09.434s,-1d03m22.62s,6,4,2,713,763,764
SDSS-II SN 14113,2006-09-16,1h53m46.676s,-0d49m06.06s,14,8,6,712,765,765
SDSS-II SN 14126,2006-09-16,3h32m10.176s,-0d40m16.5288s,14,2,12,1024,825,85
SDSS-II SN 14137,2006-09-16,3h46m04.608s,-0d24m02.6604s,4,2,2,1020,812,813
SDSS-II SN 14141,2006-11-20,1h43m27.504s,0d09m52.175s,6,2,4,18,692,309
SDSS-II SN 1415,2005-09-14,0h24m25.555s,0d35m57.51s,57,52,5,740,1496,755
SDSS-II SN 14169,2006-09-16,1h44m51.096s,0d59m16.84s,10,4,6,712,764,386
SDSS-II SN 14173,2006-09-16,3h26m45.192s,0d59m05.1936s,4,1,3,1026,1168,468
SDSS-II SN 14177,2006-09-15,22h30m22.08s,0d30m59.15s,2,1,1,751,1853,1854
SDSS-II SN 14223,2006-09-17,21h54m52.56s,-0d30m04.608s,12,4,8,25,718,14
SDSS-II SN 14227,2006-09-18,22h21m32.16s,-0d37m53.778s,2,1,1,755,1850,1851
SDSS-II SN 14231,2006-09-30,3h50m35.936s,0d47m15.36s,7,2,5,1034,1155,808
SDSS-II SN 14250,2006-09-17,0h51m17.382s,-0d36m18.87s,6,2,4,1078,398,372
SDSS-II SN 14258,2006-09-17,2h16m33.79s,-0d07m12.6s,6,2,4,1028,768,768
SDSS-II SN 14268,2006-09-22,3h28m47.862s,0d23m28.04s,7,2,5,1032,1162,462
SDSS-II SN 14305,2006-09-19,20h47m52.56s,-0d35m36.5892s,11,2,9,43,1384,307
SDSS-II SN 14308,2006-09-17,21h23m15.84s,-0d36m52.2144s,8,4,4,1,702,668
SDSS-II SN 14317,2006-09-29,21h02m16.981s,0d19m50.08s,23,11,12,1131,1029,297
SDSS-II SN 14322,2006-09-19,23h35m05.53s,-0d10m09.78s,13,7,6,1071,719,4
SDSS-II SN 14327,2006-09-19,0h09m22.98s,-0d11m24.5s,10,2,8,1064,764,381
SDSS-II SN 14330,2006-09-29,0h28m30.18s,-0d04m06.258s,10,4,6,1090,359,359
SDSS-II SN 14333,2006-09-28,1h05m08.496s,-0d00m45.34s,4,2,2,1087,374,374
SDSS-II SN 14343,2006-09-19,0h02m49.718s,-0d57m14.57s,14,4,10,1064,414,377
SDSS-II SN 14346,2006-09-28,0h28m35.7264s,-1d00m13.392s,14,4,10,1089,409,360
SDSS-II SN 14347,2006-09-17,1h07m55.396s,-1d01m01.45s,10,2,8,1076,740,385
SDSS-II SN 14361,2006-09-11,2h54m03.716s,-0d06m18.87s,9,6,3,660,1140,403
SDSS-II SN 14372,2006-09-19,3h23m14.839s,-0d08m28.35s,6,2,4,1029,817,817
SDSS-II SN 14382,2006-09-15,23h56m35.689s,0d12m15.34s,6,2,4,1060,420,38
SDSS-II SN 14389,2006-09-17,1h48m09.269s,0d17m45.91s,6,4,2,713,763,763
SDSS-II SN 14403,2006-09-28,1h07m21.17s,0d39m07.1s,20,4,16,1087,1461,395
SDSS-II SN 14425,2006-09-29,3h26m30.096s,1d10m50.052s,6,2,4,1039,807,808
SDSS-II SN 14429,2006-09-11,3h48m35.208s,-0d26m32.3952s,11,2,9,1015,1900,92
SDSS-II SN 14438,2006-09-20,22h40m15.659s,-1d04m09.51s,13,11,2,770,728,729
SDSS-II SN 14445,2006-09-27,22h43m51.036s,-0d45m14.18s,16,8,8,778,1775,734
SDSS-II SN 14446,2006-09-27,22h50m30.24s,-0d40m24.0204s,10,2,8,14,1797,11
SDSS-II SN 14453,2006-09-27,21h05m08.718s,0d56m57.98s,20,4,16,51,1812,299
SDSS-II SN 14463,2006-09-27,0h12m34.899s,-0d21m01.62s,10,2,8,11,756,31
SDSS-II SN 14470,2006-09-27,2h56m51.591s,-0d21m06.2s,8,6,2,676,386,387
SDSS-II SN 14478,2006-09-27,23h41m10.32s,0d04m09.19s,10,4,6,12,359,21
SDSS-II SN 14480,2006-09-27,0h00m04.19s,0d01m22.66s,10,2,8,1072,371,369
SDSS-II SN 14498,2006-09-27,0h47m03.312s,-1d13m28.704s,6,2,4,1088,375,362
SDSS-II SN 14500,2006-09-12,1h36m07.728s,-1d06m16.848s,10,4,6,708,767,389
SDSS-II SN 14505,2006-09-16,2h12m45.48s,-1d05m21.228s,10,6,4,1066,767,64
SDSS-II SN 14522,2006-09-27,1h54m06.89s,-0d43m31.94s,14,8,6,723,754,754
SDSS-II SN 14523,2006-09-27,2h00m30.24s,-0d42m37.89s,6,2,4,722,755,755
SDSS-II SN 14524,2006-10-02,2h46m15.082s,-0d47m51.94s,9,2,7,1070,1877,767
SDSS-II SN 14525,2006-10-02,1h07m31.872s,0d28m38.8s,11,2,9,1091,1457,370
SDSS-II SN 14531,2006-09-27,0h10m29.828s,0d29m04.69s,20,2,18,1072,734,370
SDSS-II SN 14579,2006-09-16,3h06m39.432s,-1d06m14.184s,14,2,12,1023,829,400
SDSS-II SN 14591,2006-09-27,3h20m52.272s,-0d49m49.818s,10,2,8,1037,809,389
SDSS-II SN 14619,2006-09-19,21h32m50.16s,-0d03m38.448s,564,222,342,1125,1801,310
SDSS-II SN 14624,2006-09-19,21h33m45.915s,0d20m45.28s,167,36,131,1102,702,310
SDSS-II SN 14638,2006-09-19,23h54m14.366s,-0d07m29.09s,14,2,12,1064,716,34
SDSS-II SN 14644,2006-09-22,1h36m19.364s,-0d04m10.63s,8,4,4,718,755,379
SDSS-II SN 14649,2006-09-29,1h49m42.528s,-0d09m48.3624s,6,4,2,725,751,751
SDSS-II SN 14654,2006-09-29,23h17m25.92s,-0d50m47.8536s,8,6,2,1131,740,741
SDSS-II SN 14675,2006-09-11,2h11m58.704s,-0d02m35.9196s,8,2,6,1022,799,774
SDSS-II SN 14708,2006-09-28,1h01m15.498s,-0d27m53.57s,10,2,8,1087,395,374
SDSS-II SN 14733,2006-10-03,0h56m34.752s,0d13m51.582s,12,2,10,1092,391,357
SDSS-II SN 14742,2006-09-11,3h02m09.048s,0d12m51.818s,8,2,6,1018,828,802
SDSS-II SN 14750,2006-09-29,2h18m04.564s,0d39m11.04s,10,2,8,1040,756,404
SDSS-II SN 14760,2006-09-30,3h45m00.1s,0d43m41.5s,4,2,2,1034,797,797
SDSS-II SN 14771,2006-10-04,2h47m22.752s,1d09m25.272s,6,2,4,1073,748,380
SDSS-II SN 1478,2005-09-09,2h11m07.512s,0d08m49.603s,4,2,2,655,1166,1167
SDSS-II SN 14784,2006-09-20,21h35m11.76s,-0d20m55.9s,257,115,142,1126,1458,313
SDSS-II SN 14786,2006-09-15,22h07m16.901s,-0d19m16.95s,10,2,8,2,1108,16
SDSS-II SN 14790,2006-09-20,20h41m26.4s,0d09m20.182s,14,6,8,800,1383,671
SDSS-II SN 14809,2006-09-30,22h05m30.24s,-0d39m22s,10,2,8,17,1093,1
SDSS-II SN 14831,2006-09-30,2h08m19.392s,-0d19m52.6692s,8,4,4,725,753,753
SDSS-II SN 14836,2006-09-27,3h22m22.608s,-0d14m52.4112s,6,2,4,1037,809,809
SDSS-II SN 14845,2006-09-27,0h23m54.415s,0d04m56.9s,57,52,5,1118,1118,374
SDSS-II SN 14858,2006-09-27,1h59m40.176s,0d00m08.9s,11,4,7,722,1121,755
SDSS-II SN 14883,2006-09-30,1h32m36.432s,-0d44m15.216s,10,4,6,734,749,5
SDSS-II SN 14888,2006-09-27,1h42m49.115s,-0d38m59.13s,10,4,6,723,763,375
SDSS-II SN 14896,2006-10-02,2h33m00.624s,-0d46m25.86s,17,4,13,1070,1877,750
SDSS-II SN 14900,2006-09-27,3h00m56.688s,-0d38m08.12s,10,2,8,1034,813,786
SDSS-II SN 14907,2006-09-27,3h50m35.952s,-0d40m36.732s,13,2,11,690,1884,76
SDSS-II SN 14914,2006-10-02,1h49m27.72s,-1d12m32.832s,8,4,4,728,748,749
SDSS-II SN 14916,2006-09-27,1h52m05.841s,-1d08m30.39s,10,4,6,723,754,754
SDSS-II SN 14925,2006-09-27,3h34m16.656s,-1d12m03.168s,10,2,8,1035,784,74
SDSS-II SN 14928,2006-09-27,23h40m17.52s,0d36m12.622s,10,4,6,12,359,21
SDSS-II SN 14951,2006-09-22,3h32m02.016s,0d24m50.26s,6,2,4,1030,802,460
SDSS-II SN 14963,2006-09-18,1h10m20.016s,0d57m00.63s,10,2,8,1077,1471,371
SDSS-II SN 14964,2006-09-30,1h10m31.728s,1d00m42.624s,3,2,1,1089,358,359
SDSS-II SN 14972,2006-09-30,1h53m23.448s,0d59m11.987s,33,4,29,725,1531,381
SDSS-II SN 14989,2006-09-27,21h05m00.96s,0d12m20.567s,25,9,16,772,1031,299
SDSS-II SN 15003,2006-09-22,1h29m33.264s,0d41m44.43s,6,4,2,726,375,376
SDSS-II SN 15006,2006-10-03,1h46m10.73s,0d40m01.4s,6,4,2,729,747,747
SDSS-II SN 15008,2006-09-17,2h07m23.592s,0d43m40.854s,8,4,4,712,766,766
SDSS-II SN 15033,2006-10-03,1h03m06.81s,-0d09m24.2s,6,2,4,1092,381,382
SDSS-II SN 15041,2006-10-13,1h57m06.312s,-0d08m47.7528s,8,4,4,738,738,739
SDSS-II SN 15053,2006-09-29,3h24m51.792s,-0d09m22.7448s,6,2,4,1039,808,808
SDSS-II SN 15074,2006-10-01,3h26m15.336s,0d13m18.16s,6,2,4,1041,806,806
SDSS-II SN 15075,2006-10-01,3h27m32.712s,0d20m48.66s,11,2,9,1041,1153,453
SDSS-II SN 15080,2006-09-17,21h07m31.2s,-1d02m19.392s,12,4,8,2,1041,693
SDSS-II SN 15085,2006-09-28,1h24m16.488s,-0d53m24.5292s,10,4,6,732,728,372
SDSS-II SN 15088,2006-09-17,1h36m07.152s,-0d54m15.1596s,8,4,4,713,760,384
SDSS-II SN 15093,2006-09-29,2h30m57.624s,-0d57m39.942s,8,4,4,1067,768,765
SDSS-II SN 15101,2006-10-03,21h31m08.4s,-0d29m10.086s,409,171,238,1139,1445,299
SDSS-II SN 15102,2006-10-03,22h01m28.8s,-0d35m52.44s,13,4,9,20,1089,305
SDSS-II SN 15103,2006-09-29,22h32m23.684s,-0d30m16.56s,2,1,1,765,1839,1840
SDSS-II SN 15104,2006-09-20,23h44m45.6s,-0d38m00.006s,10,2,8,5,709,7
SDSS-II SN 15108,2006-09-11,1h37m44.33s,-0d32m29.54s,10,4,6,707,766,390
SDSS-II SN 15116,2006-10-01,3h27m34.608s,-0d28m12.2232s,6,2,4,1041,806,806
SDSS-II SN 15137,2006-09-27,23h44m25.786s,-0d48m23.4s,10,4,6,12,702,21
SDSS-II SN 15160,2006-10-03,23h53m42.945s,-0d34m44.76s,14,4,10,1080,405,21
SDSS-II SN 15198,2006-10-12,2h18m30.604s,-0d12m43.96s,6,2,4,1053,743,743
SDSS-II SN 15212,2006-09-19,0h23m09.7608s,-0d04m19.488s,59,54,5,1110,1126,382
SDSS-II SN 15239,2006-10-01,0h02m25.67s,-0d55m05.448s,8,2,6,1076,372,365
SDSS-II SN 15255,2006-10-02,22h12m24s,-0d15m32.5188s,52,9,43,786,1418,689
SDSS-II SN 15263,2006-10-04,21h43m13.44s,0d00m36s,14,4,10,1130,705,284
SDSS-II SN 15272,2006-10-02,23h23m05.552s,0d05m04.06s,19,8,11,1133,1120,693
SDSS-II SN 15291,2006-10-02,22h32m20.137s,-1d09m06.16s,2,1,1,768,1836,1837
SDSS-II SN 15294,2006-10-12,21h13m54.05s,-0d43m54.9s,23,4,19,26,1763,668
SDSS-II SN 15303,2006-10-14,23h22m02.16s,0d32m27.4s,4,2,2,11,330,330
SDSS-II SN 15309,2006-10-12,20h38m55.2s,0d58m25.842s,21,10,11,822,1361,649
SDSS-II SN 15314,2006-10-02,22h33m18.96s,0d54m46.87s,2,1,1,768,1836,1836
SDSS-II SN 15324,2006-10-12,2h06m46.477s,-0d50m20.45s,8,6,2,1092,737,737
SDSS-II SN 15347,2006-10-11,21h41m37.256s,1d12m15.07s,6,4,2,1137,698,699
SDSS-II SN 15353,2006-10-21,23h21m09.998s,-0d10m33.02s,10,6,4,1152,1100,725
SDSS-II SN 15359,2006-10-11,23h09m49.53s,0d18m38.2s,8,6,2,1142,730,730
SDSS-II SN 15370,2006-10-11,0h02m52.972s,-0d30m06.44s,8,2,6,1086,358,356
SDSS-II SN 15401,2006-10-12,22h03m25.2s,0d34m34.93s,13,9,4,796,679,287
SDSS-II SN 15417,2006-10-12,1h02m13.895s,0d27m43.16s,10,2,8,1101,394,360
SDSS-II SN 15418,2006-10-12,0h55m23.138s,1d00m46.13s,12,2,10,1101,746,348
SDSS-II SN 15419,2006-10-12,1h19m37.254s,0d53m08.56s,12,4,8,746,724,47
SDSS-II SN 15422,2006-10-12,2h18m37.224s,0d31m53.317s,4,2,2,1053,743,743
SDSS-II SN 15455,2006-10-11,22h00m19.333s,-1d03m04.91s,14,8,6,49,694,297
SDSS-II SN 15467,2006-10-21,21h20m04.8s,-0d10m38.48s,8,4,4,35,668,634
SDSS-II SN 15470,2006-10-11,22h11m33.12s,-0d02m46.824s,52,9,43,795,1409,680
SDSS-II SN 15486,2006-10-21,22h59m57.487s,1d14m24.82s,12,10,2,800,719,719
SDSS-II SN 15489,2006-10-13,0h31m00.634s,-0d04m15.41s,12,2,10,3,381,327
SDSS-II SN 15496,2006-10-13,0h32m17.758s,0d16m28.35s,10,2,8,3,344,327
SDSS-II SN 15505,2006-10-11,23h37m58.32s,-0d53m03.696s,14,10,4,1093,686,344
SDSS-II SN 15516,2006-10-13,2h00m54.408s,0d39m24.433s,7,4,3,738,1105,1105
SDSS-II SN 15525,2006-10-13,3h26m06.648s,1d07m50.97s,6,2,4,1053,793,794
SDSS-II SN 15526,2006-10-17,3h36m10.632s,1d13m43.32s,4,2,2,1055,777,777
SDSS-II SN 15533,2006-10-20,23h35m27.111s,-0d22m24.11s,8,6,2,1102,334,335
SDSS-II SN 15535,2006-10-20,0h07m16.217s,-0d18m14.11s,12,2,10,1095,709,347
SDSS-II SN 15539,2006-10-14,22h07m48s,0d10m00.9588s,8,5,3,798,710,698
SDSS-II SN 15549,2006-10-11,21h34m02.596s,0d38m03.12s,512,186,326,439,1437,277
SDSS-II SN 15558,2006-10-14,22h29m58.433s,0d57m12.62s,2,1,1,780,1824,1824
SDSS-II SN 15559,2006-10-14,22h33m49.92s,0d51m02.0808s,2,1,1,780,1824,1824
SDSS-II SN 15569,2006-10-16,23h57m30.72s,0d52m12.18s,12,2,10,1091,389,6
SDSS-II SN 15587,2006-10-22,3h37m40.142s,0d59m54.16s,4,2,2,1060,773,773
SDSS-II SN 15603,2006-10-29,23h43m46.194s,-1d11m32.49s,16,14,2,1162,327,327
SDSS-II SN 15618,2006-10-02,3h48m17.52s,-0d40m55.6716s,12,2,10,695,1879,71
SDSS-II SN 15624,2006-10-02,21h23m48.72s,-0d46m29.5212s,8,4,4,16,687,297
SDSS-II SN 15633,2006-10-16,23h35m37.68s,-0d50m21.2s,8,6,2,1098,338,339
SDSS-II SN 15650,2006-10-23,20h55m35.04s,-0d10m49.5696s,7,6,1,1155,681,681
SDSS-II SN 15655,2006-10-17,22h04m42.48s,0d47m08.736s,13,9,4,801,674,282
SDSS-II SN 15660,2006-10-11,22h11m17.28s,-0d02m26.232s,52,9,43,795,1409,680
SDSS-II SN 15675,2006-10-17,22h52m41.693s,0d21m51.24s,14,12,2,796,722,723
SDSS-II SN 15690,2006-10-23,0h21m46.538s,0d47m04.0452s,67,60,7,1144,1092,5
SDSS-II SN 15697,2006-10-13,2h00m03.936s,0d46m34.655s,7,4,3,738,1105,1105
SDSS-II SN 15710,2006-10-23,3h40m12.677s,0d43m19.49s,11,2,9,1061,1132,48
SDSS-II SN 15725,2006-10-17,23h12m44.886s,-0d10m40.04s,6,4,2,1149,723,724
SDSS-II SN 15726,2006-10-04,23h17m58.728s,-0d00m25.99s,23,4,19,1135,1117,689
SDSS-II SN 15727,2006-10-21,23h25m36.002s,-0d00m51.01s,190,133,57,1152,1102,316
SDSS-II SN 15730,2006-10-03,23h59m41.76s,-0d02m30.408s,10,2,8,1078,365,363
SDSS-II SN 15737,2006-10-03,0h49m28.528s,-0d03m35.73s,6,2,4,1094,356,356
SDSS-II SN 15741,2006-10-03,1h50m41.376s,-0d06m23.598s,8,2,6,716,748,378
SDSS-II SN 15748,2006-10-23,3h12m27.499s,-0d07m50.21s,15,2,13,1063,791,363
SDSS-II SN 15751,2006-10-13,3h36m06.78s,-0d03m06.02s,6,2,4,1051,784,58
SDSS-II SN 15755,2006-10-17,23h53m36.778s,0d13m34.86s,8,2,6,1092,688,6
SDSS-II SN 15759,2006-10-13,0h59m27.432s,0d19m08.7312s,10,2,8,1102,381,359
SDSS-II SN 15761,2006-10-17,1h21m10.46s,0d20m27.7s,18,4,14,751,378,42
SDSS-II SN 15765,2006-10-21,2h11m23.318s,0d14m45.93s,4,2,2,1062,759,760
SDSS-II SN 15779,2006-10-21,23h02m34.8s,-0d27m45.18s,12,4,8,770,342,322
SDSS-II SN 15782,2006-10-17,23h30m42.291s,-0d25m40.7s,138,122,16,792,1103,678
SDSS-II SN 15784,2006-10-17,23h46m41.693s,-0d36m55.19s,6,4,2,1094,680,681
SDSS-II SN 15793,2006-10-12,1h26m32.88s,1d01m38.352s,6,4,2,746,355,356
SDSS-II SN 15803,2006-10-12,1h13m04.996s,-0d40m18.41s,20,2,18,1101,1447,356
SDSS-II SN 15805,2006-10-02,1h31m29.256s,-0d43m04.2744s,10,4,6,736,747,3
SDSS-II SN 15806,2006-10-22,1h36m22.153s,-0d49m50.27s,8,4,4,748,725,349
SDSS-II SN 15814,2006-10-16,1h58m54.045s,-0d22m21.55s,12,4,8,741,736,736
SDSS-II SN 15817,2006-10-20,1h58m15.514s,0d00m48.06s,10,4,6,745,1098,732
SDSS-II SN 15822,2006-10-22,20h45m25.2s,0d06m04.9752s,14,7,7,1161,1005,639
SDSS-II SN 15823,2006-10-29,20h57m00.635s,0d11m56.73s,5,4,1,1161,992,992
SDSS-II SN 15850,2006-10-20,0h02m40.21s,-1d09m54.45s,8,2,6,1095,353,346
SDSS-II SN 15860,2006-10-16,0h18m23.381s,0d10m59.11s,12,2,10,30,377,12
SDSS-II SN 15865,2006-10-27,3h48m16.08s,0d29m55.64s,6,2,4,1061,778,775
SDSS-II SN 15866,2006-10-22,22h35m07.412s,0d58m04.94s,2,1,1,788,1816,1816
SDSS-II SN 15903,2006-10-21,3h15m37.447s,-0d36m09.16s,9,2,7,1061,785,405
SDSS-II SN 15916,2006-10-23,23h32m58.56s,0d18m26.1s,255,141,114,1105,739,314
SDSS-II SN 15929,2006-10-29,22h58m22.08s,-0d15m09.162s,27,7,20,808,1073,335
SDSS-II SN 15935,2006-10-20,21h43m51.12s,0d26m23.89s,6,4,2,1146,689,689
SDSS-II SN 15941,2006-10-22,22h11m43.683s,-0d41m05.31s,10,4,6,806,703,669
SDSS-II SN 15944,2006-10-14,23h14m45.803s,0d25m36.16s,10,6,4,1145,726,330
SDSS-II SN 15945,2006-10-27,23h37m20.444s,0d29m58.97s,8,6,2,1109,328,329
SDSS-II SN 15946,2006-11-08,23h40m45.12s,0d37m56.147s,10,6,4,54,317,317
SDSS-II SN 15953,2006-11-22,1h12m56.753s,0d56m25.15s,22,4,18,786,1447,304
SDSS-II SN 15955,2006-10-16,0h34m21.5064s,-1d12m14.904s,10,4,6,6,339,327
SDSS-II SN 15961,2006-10-22,0h14m59.94s,-0d48m15.4656s,12,2,10,36,737,6
SDSS-II SN 15967,2006-10-16,1h28m20.24s,-0d46m15.48s,11,4,7,750,1104,710
SDSS-II SN 15973,2006-10-20,1h46m21.744s,0d53m22.999s,10,4,6,746,730,352
SDSS-II SN 15987,2006-10-12,0h16m02.124s,0d06m43.85s,16,2,14,26,747,16
SDSS-II SN 15988,2006-09-30,0h25m00.91s,0d00m32.2s,12,4,8,1091,395,374
SDSS-II SN 15992,2006-09-18,0h35m32.62s,0d01m30.8s,18,2,16,1083,418,42
SDSS-II SN 15994,2006-10-29,0h47m43.781s,0d06m01.66s,8,2,6,1120,370,342
SDSS-II SN 16001,2006-10-12,1h29m02.64s,0d02m12.69s,8,4,4,746,735,359
SDSS-II SN 16015,2006-10-21,0h14m52.6776s,-0d25m34.0464s,12,2,10,35,738,7
SDSS-II SN 16039,2006-10-16,1h37m48.264s,-1d05m48.012s,10,4,6,742,733,344
SDSS-II SN 16044,2006-10-16,2h45m40.44s,-1d05m16.98s,3,1,2,1084,1853,1840
SDSS-II SN 16054,2006-11-09,22h31m21.84s,1d03m37.224s,2,1,1,806,1798,1798
SDSS-II SN 16094,2006-10-17,0h36m54.3888s,1d06m35.928s,10,2,8,1112,695,695
SDSS-II SN 16104,2006-10-22,21h06m15.36s,-1d03m59.22s,12,4,8,37,1006,658
SDSS-II SN 16111,2006-10-22,21h57m16.063s,0d56m07.62s,22,14,8,806,696,279
SDSS-II SN 16121,2006-10-27,3h16m54.936s,-0d21m21.528s,14,2,12,1067,779,399
SDSS-II SN 16125,2006-10-27,0h49m29.688s,0d03m19.93s,6,2,4,1118,332,332
SDSS-II SN 16129,2006-10-20,3h13m59.52s,0d12m46.73s,9,2,7,1060,794,406
SDSS-II SN 16130,2006-10-29,3h27m05.962s,0d09m28.22s,6,2,4,1069,778,778
SDSS-II SN 16136,2006-11-08,2h13m56.605s,-0d43m53.74s,8,4,4,1119,715,716
SDSS-II SN 16142,2006-10-29,0h04m05.9496s,0d29m10.813s,16,2,14,1104,374,337
SDSS-II SN 16148,2006-10-27,3h14m38.697s,0d35m17.77s,23,2,21,1067,1128,359
SDSS-II SN 16153,2006-10-22,3h27m29.736s,0d53m43.91s,7,2,5,1062,1132,432
SDSS-II SN 16163,2006-11-09,2h05m59.76s,-0d51m21.1s,12,6,6,1120,712,709
SDSS-II SN 16172,2006-11-01,3h50m49.339s,-0d13m08.98s,14,2,12,1066,1479,776
SDSS-II SN 16199,2006-10-23,22h11m46.639s,1d08m06.12s,55,6,49,806,1399,276
SDSS-II SN 16202,2006-10-21,21h27m11.04s,-0d04m49.35s,18,8,10,79,670,277
SDSS-II SN 16220,2006-09-28,0h39m42.185s,0d40m48.65s,12,4,8,698,714,345
SDSS-II SN 16237,2006-10-31,1h32m02.52s,-0d37m24.6s,10,6,4,765,718,712
SDSS-II SN 16238,2006-10-31,1h51m39.633s,-0d26m08.84s,8,4,4,757,720,720
SDSS-II SN 16298,2006-10-22,22h01m38.88s,0d34m34.2s,10,8,2,806,699,700
SDSS-II SN 16301,2006-10-29,21h50m06.96s,1d01m59.916s,9,7,2,813,662,662
SDSS-II SN 16302,2006-10-29,22h07m04.13s,0d11m00.3s,20,9,11,813,1064,683
SDSS-II SN 16356,2006-11-09,21h12m48.435s,-0d34m02.26s,14,4,10,54,988,640
SDSS-II SN 16360,2006-10-28,22h50m14.64s,-0d30m31.4352s,10,4,6,45,1766,707
SDSS-II SN 16393,2006-11-09,21h46m00.296s,-0d03m38.57s,8,4,4,1166,669,623
SDSS-II SN 16405,2006-11-09,23h44m24.946s,0d22m04.42s,10,8,2,1117,657,658
SDSS-II SN 16410,2006-11-02,21h18m51.6s,0d38m52.3s,9,7,2,810,683,684
SDSS-II SN 16431,2006-10-27,2h09m43.656s,0d29m17.74s,18,6,12,1068,753,726
SDSS-II SN 16433,2006-10-29,2h27m59.016s,-1d10m09.264s,6,2,4,357,715,715
SDSS-II SN 16434,2006-10-29,2h51m08.454s,-1d10m13.55s,11,2,9,1069,1819,355
SDSS-II SN 16441,2006-11-11,21h59m37.2s,-0d39m49.32s,22,8,14,80,663,266
SDSS-II SN 16451,2006-11-14,0h33m53.6976s,0d09m03.78s,12,4,8,1140,313,295
SDSS-II SN 16455,2006-10-27,21h55m21.12s,-0d23m36.15s,12,6,6,65,678,302
SDSS-II SN 16458,2006-10-29,23h47m13.2s,-0d16m04.332s,6,4,2,1106,668,669
SDSS-II SN 16460,2006-11-08,0h44m02.322s,-0d13m47.88s,8,2,6,1130,327,320
SDSS-II SN 16462,2006-11-14,1h08m09.739s,-0d23m11.12s,10,2,8,1134,1456,327
SDSS-II SN 16467,2006-10-29,21h54m20.576s,0d07m05.81s,12,6,6,67,676,300
SDSS-II SN 16468,2006-10-29,0h15m32.1312s,0d06m57.431s,18,4,14,43,731,686
SDSS-II SN 16472,2006-10-29,1h33m02.469s,0d09m57.55s,8,4,4,755,718,342
SDSS-II SN 16477,2006-10-22,0h41m25.13s,0d31m55.3s,16,2,14,1113,690,321
SDSS-II SN 1650,2005-09-10,23h34m02.656s,0d41m00.04s,38,6,32,697,1123,14
SDSS-II SN 16547,2006-10-29,1h25m21.288s,-1d07m09.588s,16,6,10,1101,719,341
SDSS-II SN 16551,2006-10-27,0h01m47.52s,-0d40m22.4s,8,2,6,1102,341,339
SDSS-II SN 16565,2006-11-09,1h00m35.256s,-0d04m38.4852s,8,2,6,1129,344,332
SDSS-II SN 16572,2006-11-09,23h43m56.4s,0d20m29.555s,10,8,2,1117,657,658
SDSS-II SN 16582,2006-10-21,21h48m57.84s,-0d26m01.9932s,6,4,2,1159,697,697
SDSS-II SN 16586,2006-11-09,23h53m21.6s,-0d32m19.5s,8,4,4,1117,368,367
SDSS-II SN 16606,2006-10-31,22h50m26.601s,1d13m22.02s,8,6,2,810,708,709
SDSS-II SN 16626,2006-11-14,0h36m10.7592s,-0d48m27.9396s,20,4,16,35,361,298
SDSS-II SN 16637,2006-11-14,0h32m43.33s,-0d19m23.7s,8,2,6,13,349,295
SDSS-II SN 16652,2006-11-10,0h22m43.15s,0d00m45.1s,59,56,3,1162,1074,330
SDSS-II SN 16715,2006-11-11,21h16m02.16s,-0d43m56.352s,20,4,16,56,1733,667
SDSS-II SN 16721,2006-10-24,21h47m04.255s,-0d15m56.42s,4,2,2,1150,685,639
SDSS-II SN 16724,2006-11-11,21h57m26.4s,0d06m21.92s,22,8,14,80,662,259
SDSS-II SN 16831,2006-11-14,22h24m54.72s,-0d23m03.84s,2,1,1,812,1793,1794
SDSS-II SN 16841,2006-11-08,1h35m18.24s,0d09m26.53s,8,4,4,765,708,332
SDSS-II SN 1686,2005-09-03,0h08m59.6s,-0d12m37.5s,14,2,12,683,1145,759
SDSS-II SN 16878,2006-09-11,21h44m48.96s,-0d07m27.7212s,8,4,4,1107,728,682
SDSS-II SN 16879,2006-11-09,21h55m07.2s,-0d04m25.284s,12,6,6,78,665,289
SDSS-II SN 16937,2006-10-03,21h51m31.68s,-0d27m56.862s,6,4,2,1141,715,715
SDSS-II SN 16940,2006-11-09,23h33m12.48s,-0d25m04.404s,162,81,81,1122,1080,297
SDSS-II SN 16945,2006-10-31,3h22m21.768s,-0d28m04.1844s,10,2,8,1071,776,775
SDSS-II SN 16946,2006-11-16,3h50m14.76s,-0d27m49.284s,18,4,14,1081,1464,26
SDSS-II SN 16950,2006-11-11,21h55m54.72s,0d31m00.9336s,12,6,6,80,662,259
SDSS-II SN 16975,2006-11-14,1h54m11.832s,-0d19m40.0296s,18,4,14,771,1486,706
SDSS-II SN 16976,2006-11-13,1h55m10.848s,-0d24m43.128s,22,8,14,770,1487,707
SDSS-II SN 17031,2006-11-14,1h43m51.559s,-0d40m32.83s,10,4,6,771,715,327
SDSS-II SN 17068,2006-10-03,1h14m16.368s,-0d07m41.9448s,14,2,12,1092,1816,365
SDSS-II SN 17169,2007-09-05,22h56m23.28s,-0d40m05.5668s,11,9,2,1119,379,379
SDSS-II SN 17191,2007-09-03,3h32m15.24s,-0d51m24.48s,10,4,6,1376,443,127
SDSS-II SN 17205,2007-09-03,2h26m03.216s,0d48m25.52s,60,56,4,1379,416,416
SDSS-II SN 17206,2007-09-03,3h03m56.474s,0d43m41.74s,15,2,13,1375,817,47
SDSS-II SN 17219,2007-09-03,0h12m46.6632s,-0d06m08.8416s,18,4,14,352,415,377
SDSS-II SN 17337,2007-09-03,2h12m03.12s,0d14m04.1172s,4,2,2,1379,442,443
SDSS-II SN 17372,2007-09-03,0h15m45.7224s,-0d04m17.544s,16,4,12,352,421,377
SDSS-II SN 17395,2007-09-03,23h37m37.493s,-0d57m02.29s,10,8,2,1420,16,17
SDSS-II SN 1740,2005-09-10,0h21m37.07s,-0d52m51.19s,20,6,14,732,1115,370
SDSS-II SN 17421,2007-09-03,23h29m32.577s,0d40m33.52s,26,17,9,1469,783,357
SDSS-II SN 17423,2007-09-05,23h02m34.146s,-0d50m18.31s,15,11,4,1435,399,3
SDSS-II SN 17433,2007-09-03,0h12m44.431s,-0d02m03.5412s,16,4,12,352,415,377
SDSS-II SN 17473,2007-09-14,0h49m01.896s,0d32m53.2s,8,2,6,1440,50,22
SDSS-II SN 1750,2005-09-03,23h37m34.623s,-0d28m33.11s,12,4,8,690,1089,385
SDSS-II SN 17508,2007-09-03,0h44m24.384s,0d40m03.1908s,14,2,12,1429,54,5
SDSS-II SN 17527,2007-09-03,0h01m04.9337s,-0d10m27.9228s,8,2,6,1413,30,28
SDSS-II SN 17542,2007-09-03,22h18m42.96s,0d40m18.062s,219,166,53,1463,1500,7
SDSS-II SN 17577,2007-09-05,22h07m39.55s,-1d03m16.7s,14,12,2,1124,352,353
SDSS-II SN 1762,2005-09-03,0h03m06.851s,-0d26m19.8132s,8,2,6,683,761,759
SDSS-II SN 17641,2007-09-04,2h30m33.288s,-1d10m25.212s,6,4,2,1407,424,425
SDSS-II SN 17647,2007-09-14,2h17m07.728s,-0d48m05.59s,10,6,4,1429,406,396
SDSS-II SN 17667,2007-09-04,2h29m25.032s,-0d49m10.7256s,12,4,8,1046,405,44
SDSS-II SN 17692,2007-09-05,22h48m15.36s,0d53m43.318s,12,10,2,1121,399,399
SDSS-II SN 17716,2007-09-04,1h31m04.2s,0d29m45.683s,8,4,4,1073,408,32
SDSS-II SN 17737,2007-09-04,3h01m50.304s,0d36m18.803s,8,2,6,1376,470,444
SDSS-II SN 17743,2007-09-04,3h38m39.456s,0d58m18.41s,4,2,2,1377,456,456
SDSS-II SN 17748,2007-09-14,0h39m13.673s,-0d16m39.05s,14,4,10,5,57,10
SDSS-II SN 17773,2007-09-04,2h13m08.214s,-0d18m22.53s,6,2,4,1380,415,416
SDSS-II SN 17803,2007-09-13,22h33m43.92s,-0d27m37.224s,2,1,1,1114,1490,1491
SDSS-II SN 17816,2007-09-05,23h56m38.16s,-0d27m39.4452s,10,4,6,1415,65,0
SDSS-II SN 17820,2007-09-05,1h04m33.527s,-0d27m59.26s,12,2,10,1429,53,32
SDSS-II SN 17829,2007-09-14,3h32m07.58s,-0d50m07.7s,11,4,7,1387,806,116
SDSS-II SN 1783,2005-09-09,20h37m45.12s,-0d37m40.728s,16,7,9,424,1759,328
SDSS-II SN 17835,2007-09-12,2h27m53.256s,-0d33m12.1212s,67,55,12,1054,398,36
SDSS-II SN 17851,2007-09-03,2h25m11.016s,0d45m33.03s,16,12,4,1379,417,417
SDSS-II SN 17882,2007-09-15,1h00m04.446s,1d14m47.45s,14,2,12,1439,386,7
SDSS-II SN 17899,2007-09-05,23h34m47.89s,-0d09m05.68s,110,66,44,1422,422,0
SDSS-II SN 17902,2007-09-03,0h44m31.08s,-0d04m37.1172s,8,2,6,1429,28,21
SDSS-II SN 17906,2007-09-15,3h44m56.52s,0d24m08.7s,4,2,2,1384,448,449
SDSS-II SN 17915,2007-09-03,3h30m19.176s,0d24m19.847s,7,2,5,1378,816,116
SDSS-II SN 17925,2007-09-05,23h05m13.447s,0d18m14.53s,7,5,2,1412,400,401
SDSS-II SN 17927,2007-09-13,22h19m26.16s,0d39m12.154s,210,160,50,1473,1490,342
SDSS-II SN 17928,2007-09-15,23h53m52.8s,1d06m51.3s,18,8,10,1425,410,5
SDSS-II SN 17934,2007-09-22,0h47m02.856s,-0d11m07.1088s,8,2,6,1448,9,2
SDSS-II SN 17945,2007-09-14,1h47m00.689s,-0d18m07.65s,6,4,2,1075,401,401
SDSS-II SN 17949,2007-09-14,1h56m49.235s,-0d14m07.91s,14,4,10,1074,1182,403
SDSS-II SN 17955,2007-09-05,23h02m57.36s,-0d20m59.8092s,10,2,8,327,23,3
SDSS-II SN 17957,2007-09-14,1h34m21.384s,-0d40m14.5596s,10,4,6,1075,400,22
SDSS-II SN 17958,2007-09-14,2h17m44.398s,-0d42m46.4s,4,2,2,1390,406,407
SDSS-II SN 17965,2007-09-14,22h43m17.68s,-0d45m31.65s,10,4,6,366,1423,382
SDSS-II SN 17967,2007-09-14,23h02m07.102s,-0d39m34.87s,21,13,8,1444,390,6
SDSS-II SN 17976,2007-09-14,0h20m35.2608s,-1d15m07.848s,10,4,6,1466,352,17
SDSS-II SN 17999,2007-09-14,1h00m46.944s,0d31m04.7028s,6,2,4,1438,57,23
SDSS-II SN 18011,2007-09-19,23h06m39.12s,0d05m27s,7,5,2,1426,386,387
SDSS-II SN 18033,2007-09-14,1h01m25.032s,-0d19m49.9476s,16,2,14,1438,44,23
SDSS-II SN 18034,2007-09-03,1h08m32.424s,-0d13m06.3372s,10,2,8,1427,1163,34
SDSS-II SN 18038,2007-09-14,1h25m49.08s,-0d13m15.1644s,14,4,10,1083,377,21
SDSS-II SN 18041,2007-09-14,0h43m34.886s,-0d41m55.06s,10,4,6,5,37,10
SDSS-II SN 18047,2007-09-14,1h28m17.812s,-0d39m28.72s,11,4,7,1083,771,377
SDSS-II SN 18049,2007-09-19,0h25m14.55s,-0d22m03.1s,10,4,6,1445,41,17
SDSS-II SN 18067,2007-09-04,3h36m34.416s,1d01m19.056s,4,2,2,1377,456,456
SDSS-II SN 18071,2007-09-14,3h48m17.184s,0d58m46.506s,6,2,4,1383,456,453
SDSS-II SN 18076,2007-09-04,1h45m30.48s,-1d07m37.2s,6,4,2,1065,411,412
SDSS-II SN 18082,2007-09-04,2h11m20.232s,-1d04m18.12s,8,4,4,1064,414,414
SDSS-II SN 18100,2007-09-14,1h57m43.872s,0d25m26.886s,7,4,3,1074,769,769
SDSS-II SN 18116,2007-09-04,3h01m54.24s,0d35m08.5164s,8,2,6,1376,470,444
SDSS-II SN 18129,2007-09-14,2h14m36.432s,-0d42m58.0068s,10,4,6,1429,405,396
SDSS-II SN 18130,2007-09-14,3h33m45.888s,0d35m43.271s,6,2,4,1387,445,103
SDSS-II SN 18146,2007-09-05,2h09m43.052s,-0d00m01.49s,8,4,4,1065,413,413
SDSS-II SN 18170,2007-09-14,3h34m02.712s,-0d45m41.9328s,12,4,8,1387,448,116
SDSS-II SN 18175,2007-09-14,1h43m58.006s,-0d23m56.29s,10,4,6,1075,411,23
SDSS-II SN 18182,2007-09-14,2h08m51.936s,-0d19m17.2452s,8,4,4,1074,404,404
SDSS-II SN 18188,2007-09-14,2h30m29.208s,-0d18m20.1852s,60,52,8,1056,402,34
SDSS-II SN 18218,2007-09-14,23h17m32.16s,0d56m12.113s,16,8,8,1480,1464,365
SDSS-II SN 18221,2007-09-14,23h03m34.08s,-0d22m29.9712s,23,13,10,1444,391,5
SDSS-II SN 18224,2007-09-14,23h12m41.909s,-0d18m46.12s,6,4,2,1481,391,392
SDSS-II SN 1823,2005-09-10,21h02m02.16s,0d21m52.42s,23,6,17,747,1413,1
SDSS-II SN 18253,2007-09-15,23h02m20.252s,-0d54m30.23s,15,13,2,1445,389,390
SDSS-II SN 18254,2007-09-05,23h25m33.764s,-0d58m55.94s,15,4,11,1472,780,355
SDSS-II SN 18256,2007-09-05,1h27m34.752s,-0d53m33.2952s,13,4,9,1074,780,386
SDSS-II SN 18275,2007-09-05,22h55m29.52s,-0d37m20.514s,11,9,2,1119,379,379
SDSS-II SN 18276,2007-09-15,23h09m16.084s,-0d27m28.04s,8,6,2,1481,391,391
SDSS-II SN 18301,2007-09-15,23h15m51.997s,0d48m58.82s,10,8,2,1481,390,391
SDSS-II SN 18304,2007-09-22,0h08m34.077s,0d48m15.53s,14,4,10,371,378,10
SDSS-II SN 18307,2007-09-14,1h52m52.872s,0d50m01.518s,31,4,27,1074,1182,32
SDSS-II SN 18324,2007-09-15,0h25m31.467s,0d47m37.99s,22,2,20,1088,378,21
SDSS-II SN 18339,2007-09-22,2h07m29.301s,1d09m33.62s,6,4,2,1082,386,387
SDSS-II SN 1835,2005-09-10,20h50m39.36s,1d04m18.696s,29,8,21,754,1439,3
SDSS-II SN 18362,2007-09-15,0h40m32.786s,-0d10m55.14s,10,4,6,6,56,9
SDSS-II SN 18374,2007-09-15,0h10m15.566s,-0d10m37.3s,22,2,20,1425,403,20
SDSS-II SN 18380,2007-09-03,1h10m52.2s,0d16m31.282s,11,2,9,1427,1162,35
SDSS-II SN 18430,2007-09-14,1h29m25.789s,0d05m22.33s,8,4,4,1083,398,22
SDSS-II SN 18450,2007-09-14,2h26m04.944s,-0d43m39.576s,7,1,6,677,396,34
SDSS-II SN 18454,2007-09-19,3h50m58.968s,-0d17m00.168s,14,2,12,1388,1157,454
SDSS-II SN 18459,2007-09-16,1h32m18.024s,0d04m01.117s,8,4,4,1077,396,20
SDSS-II SN 18468,2007-10-03,1h53m18.984s,0d53m57.311s,31,4,27,1093,1163,13
SDSS-II SN 18473,2007-09-14,23h11m29.76s,-0d14m27.2s,8,6,2,1480,392,392
SDSS-II SN 18475,2007-11-20,23h02m48.72s,0d02m56.16s,12,10,2,403,324,325
SDSS-II SN 1858,2005-10-26,3h03m44.376s,0d25m03.414s,10,2,8,698,1144,724
SDSS-II SN 18589,2007-10-03,22h43m20.3s,-1d08m29s,5,3,2,1149,1404,1404
SDSS-II SN 18630,2007-10-03,23h11m55.217s,-0d15m51.71s,8,6,2,1499,373,373
SDSS-II SN 18644,2007-09-19,0h17m10.8816s,-0d18m15.5844s,12,4,8,368,405,361
SDSS-II SN 18666,2007-10-03,22h50m15.482s,0d11m41.32s,12,10,2,1149,371,371
SDSS-II SN 18704,2007-09-15,0h46m05.249s,-0d31m35.98s,8,2,6,1441,16,9
SDSS-II SN 18722,2007-09-15,0h56m15.84s,-0d27m50.148s,9,2,7,1441,770,17
SDSS-II SN 18747,2007-09-15,0h55m22.451s,0d14m19.55s,12,2,10,1441,56,9
SDSS-II SN 18767,2007-09-22,0h18m08.3s,0d48m31s,14,4,10,371,35,12
SDSS-II SN 18789,2007-10-08,2h08m20.14s,-0d53m12.6s,8,6,2,1453,376,376
SDSS-II SN 18797,2007-10-03,2h26m33.96s,-0d37m32.2s,17,5,12,1059,377,15
SDSS-II SN 18802,2007-09-22,3h25m54.192s,-0d31m36.786s,6,2,4,1397,450,450
SDSS-II SN 18803,2007-09-22,3h32m36.648s,-0d25m26.94s,6,2,4,285,453,95
SDSS-II SN 18839,2007-09-22,2h24m02.904s,-0d02m54.5316s,6,2,4,1398,398,398
SDSS-II SN 18917,2007-09-19,3h45m32.112s,0d02m20.27s,4,2,2,1388,444,445
SDSS-II SN 18920,2007-10-03,3h32m54.054s,0d31m57.95s,6,2,4,1406,426,84
SDSS-II SN 18941,2007-10-08,0h40m47.352s,-0d06m41.2488s,10,6,4,29,33,2
SDSS-II SN 18947,2007-09-15,0h44m44.83s,-0d52m14.3s,10,4,6,6,36,9
SDSS-II SN 18948,2007-10-08,1h03m02.232s,-0d51m08.964s,12,4,8,1462,20,1
SDSS-II SN 18952,2007-10-08,0h45m13.667s,0d49m40.39s,12,8,4,1464,19,0
SDSS-II SN 18953,2007-09-22,1h25m00.072s,0d41m53.84s,8,4,4,1091,370,11
SDSS-II SN 18971,2007-10-08,2h05m46.927s,1d12m31.87s,8,6,2,1452,370,371
SDSS-II SN 18973,2007-10-08,2h22m53.04s,1d14m53.16s,10,2,8,1414,407,382
SDSS-II SN 18990,2007-09-22,1h03m53.462s,-0d35m32.01s,12,2,10,1446,36,15
SDSS-II SN 18993,2007-10-08,1h37m16.947s,-0d30m13.91s,10,8,2,1099,374,375
SDSS-II SN 19013,2007-10-06,21h15m28.8s,-0d40m13.134s,4,2,2,385,344,338
SDSS-II SN 19014,2007-10-06,21h25m48s,-0d38m46.0932s,12,10,2,429,320,321
SDSS-II SN 19030,2007-10-06,20h42m43.2s,0d11m50.53s,14,6,8,1181,1002,290
SDSS-II SN 19032,2007-10-06,21h04m06s,0d02m02.695s,23,13,10,1503,657,309
SDSS-II SN 19052,2007-10-06,23h32m58.569s,0d33m45.6s,255,187,68,1453,391,12
SDSS-II SN 19059,2007-09-22,1h04m59.808s,0d25m32.329s,14,2,12,1446,36,0
SDSS-II SN 19065,2007-10-12,1h31m06.6s,0d29m07.1988s,8,6,2,1111,370,371
SDSS-II SN 19068,2007-10-06,21h48m08.88s,1d02m10.716s,6,4,2,1497,345,346
SDSS-II SN 19069,2007-10-06,21h49m20.4s,1d03m04.788s,9,7,2,1155,320,320
SDSS-II SN 19078,2007-09-16,0h06m22.888s,1d03m05.19s,16,4,12,365,384,16
SDSS-II SN 19091,2007-09-19,23h57m51.908s,-0d18m13.01s,16,6,10,1429,51,14
SDSS-II SN 19099,2007-10-06,0h06m55.442s,0d10m29.359s,14,12,2,1446,32,33
SDSS-II SN 19104,2007-09-14,0h48m38.16s,0d08m28.925s,12,2,10,1440,50,10
SDSS-II SN 19132,2007-09-19,0h21m06.882s,-0d44m54.82s,14,6,8,1092,376,16
SDSS-II SN 19140,2007-09-14,1h38m57.456s,-1d09m55.44s,10,4,6,1075,400,11
SDSS-II SN 19144,2007-10-03,2h49m53.83s,-1d13m07.7s,5,2,3,1408,753,16
SDSS-II SN 19165,2007-10-03,1h41m29.821s,0d32m47.61s,6,4,2,335,375,376
SDSS-II SN 19188,2007-09-30,20h54m09.12s,-0d10m54.084s,12,9,3,1497,655,339
SDSS-II SN 19200,2007-09-22,22h42m47.28s,0d22m23.743s,12,4,8,374,1415,375
SDSS-II SN 19209,2007-09-30,22h57m03.197s,-0d53m15.44s,13,11,2,1144,354,354
SDSS-II SN 1921,2005-09-09,21h02m48s,0d50m33.198s,29,6,23,746,1414,2
SDSS-II SN 19246,2007-09-22,23h26m38.64s,-0d51m55.5s,12,4,8,1489,405,389
SDSS-II SN 19308,2007-10-08,23h26m30.72s,0d47m21.491s,38,25,13,1084,748,322
SDSS-II SN 19332,2007-10-08,1h22m35.3s,-0d08m11.3s,10,4,6,16,21,14
SDSS-II SN 19335,2007-09-30,23h20m13.974s,0d23m42.62s,6,4,2,362,375,376
SDSS-II SN 19336,2007-09-30,23h55m30.602s,0d15m50.36s,8,4,4,1440,340,44
SDSS-II SN 19338,2007-09-22,0h06m25.0752s,0d22m07.59s,10,2,8,1432,46,10
SDSS-II SN 19339,2007-10-08,0h23m58.647s,0d18m44.82s,57,52,5,1494,742,1
SDSS-II SN 19344,2007-10-11,1h38m44.376s,0d22m35.8s,10,2,8,16,1477,373
SDSS-II SN 19346,2007-10-08,1h57m40.176s,0d19m38.96s,7,4,3,1098,745,745
SDSS-II SN 19359,2007-10-13,3h20m37.632s,0d20m34.35s,10,2,8,1418,428,428
SDSS-II SN 19361,2007-09-22,3h28m37.248s,0d22m47.708s,7,2,5,1397,797,97
SDSS-II SN 19377,2007-10-08,2h49m10.704s,-0d51m11.7432s,7,2,5,1413,748,11
SDSS-II SN 19399,2007-09-22,3h42m52.56s,0d49m55.05s,4,2,2,1391,440,440
SDSS-II SN 19408,2007-10-08,3h40m01.704s,0d19m17.638s,7,2,5,301,782,434
SDSS-II SN 19414,2007-10-06,22h06m22.017s,0d02m25.69s,10,4,6,388,722,341
SDSS-II SN 19417,2007-10-06,21h55m40.08s,0d30m17.9s,12,8,4,409,333,320
SDSS-II SN 19449,2007-10-06,0h38m12.649s,0d35m30.14s,12,10,2,1071,341,342
SDSS-II SN 19467,2007-10-09,22h43m51.594s,-0d58m36.82s,6,4,2,1155,1398,1398
SDSS-II SN 19468,2007-09-30,22h52m19.92s,-0d50m45.708s,10,4,6,382,1429,370
SDSS-II SN 19484,2007-10-11,2h02m46.32s,-0d54m23.9472s,8,4,4,1101,376,377
SDSS-II SN 19490,2007-10-13,21h30m19.2s,-0d33m04.536s,269,177,92,1514,1070,274
SDSS-II SN 19494,2007-10-08,23h41m44.746s,-0d26m36.55s,12,10,2,388,326,326
SDSS-II SN 19499,2007-10-08,21h49m30.48s,-0d07m54.6672s,6,4,2,1511,345,345
SDSS-II SN 19517,2007-10-08,0h37m39.3624s,-0d02m17.4588s,12,8,4,29,33,1
SDSS-II SN 19518,2007-09-22,0h44m28.183s,-0d06m12.73s,8,2,6,1448,9,2
SDSS-II SN 19525,2007-10-20,1h35m07.941s,-0d11m02.53s,12,8,4,1111,362,363
SDSS-II SN 19531,2007-10-20,3h16m56.582s,-0d35m09.24s,9,2,7,1425,421,41
SDSS-II SN 19545,2007-10-13,22h01m46.342s,0d24m04.32s,10,8,2,1162,343,344
SDSS-II SN 19549,2007-09-22,23h45m15.6s,0d19m12.7s,10,8,2,1434,340,341
SDSS-II SN 19552,2007-09-16,0h18m49.98s,0d20m27.7s,14,10,4,1455,32,18
SDSS-II SN 19555,2007-10-08,1h03m23.64s,0d18m10.35s,8,4,4,1462,11,12
SDSS-II SN 19573,2007-10-09,22h16m31.68s,0d44m16.699s,218,168,50,1499,1410,316
SDSS-II SN 19575,2007-10-09,22h32m29.52s,0d45m11.218s,2,1,1,1140,1464,1464
SDSS-II SN 1958,2005-09-12,21h50m00.96s,0d52m25.72s,9,4,5,401,1074,11
SDSS-II SN 19582,2007-10-13,0h10m04.8072s,0d47m40.902s,22,10,12,1453,353,353
SDSS-II SN 19593,2007-10-20,1h59m52.676s,0d40m44.41s,7,4,3,1110,733,733
SDSS-II SN 19599,2007-10-13,22h59m54.136s,1d09m53.06s,12,10,2,1157,362,362
SDSS-II SN 19608,2007-10-13,3h43m54.648s,1d08m05.136s,4,2,2,1412,419,419
SDSS-II SN 19619,2007-11-09,2h10m32.472s,1d00m42.66s,10,2,8,1446,349,349
SDSS-II SN 19668,2007-10-12,23h47m44.88s,-0d37m41.1s,6,4,2,1454,320,321
SDSS-II SN 19689,2007-10-31,1h08m06.48s,-0d04m55.5708s,10,4,6,1485,1105,10
SDSS-II SN 19690,2007-09-16,1h08m07.272s,-0d08m24.648s,3,1,2,1440,55,21
SDSS-II SN 19723,2007-10-13,22h35m34.026s,0d25m03.8s,3,1,2,1144,1460,1460
SDSS-II SN 19758,2007-10-30,23h19m08.16s,1d12m50.184s,12,4,8,392,1418,319
SDSS-II SN 19762,2007-10-08,0h01m36.762s,1d09m27.54s,14,10,4,1448,0,0
SDSS-II SN 19764,2007-10-08,0h25m54.404s,1d11m30.95s,14,4,10,1111,355,1
SDSS-II SN 19769,2007-10-20,23h21m46.451s,-0d58m34.73s,12,4,8,382,380,329
SDSS-II SN 19776,2007-10-09,23h13m46.32s,-0d28m45.336s,6,4,2,1506,366,367
SDSS-II SN 19778,2007-10-13,23h18m45.314s,-0d29m49.13s,22,4,18,1509,743,315
SDSS-II SN 1978,2005-09-09,22h16m55.68s,0d59m41.41s,226,120,106,739,2170,366
SDSS-II SN 1979,2005-09-09,22h17m25.478s,0d56m41.1s,215,114,101,739,2224,366
SDSS-II SN 19791,2007-10-13,0h31m35.532s,-0d06m28.782s,14,12,2,368,16,17
SDSS-II SN 19821,2007-10-12,23h47m07.054s,1d01m33.73s,12,10,2,392,330,330
SDSS-II SN 19825,2007-10-17,2h18m33.09s,0d52m51.34s,14,2,12,1423,398,6
SDSS-II SN 19986,2007-10-18,1h58m29.864s,0d09m28.84s,7,4,3,1108,735,735
SDSS-II SN 19987,2007-10-18,1h04m10.778s,-0d19m35.15s,12,6,6,1472,10,2
SDSS-II SN 20033,2007-10-29,1h31m43.272s,-0d43m54.57s,10,6,4,1128,355,349
SDSS-II SN 20043,2007-10-09,22h14m43.92s,1d12m06.192s,56,6,50,1157,1403,316
SDSS-II SN 20046,2007-10-20,21h25m58.386s,0d48m04.71s,19,6,13,399,1384,269
SDSS-II SN 20047,2007-10-14,21h46m21.802s,0d37m52.24s,8,6,2,1505,337,338
SDSS-II SN 20141,2007-10-30,23h50m10.1s,-0d31m25.81s,8,4,4,1472,13,12
SDSS-II SN 20152,2007-10-31,21h46m13.2s,1d01m40.8s,8,6,2,1522,295,295
SDSS-II SN 20171,2007-10-15,0h12m02.38s,0d12m45.9s,26,6,20,1455,373,335
SDSS-II SN 20191,2007-10-20,2h08m35.976s,0d13m27.79s,10,4,6,1110,368,368
SDSS-II SN 20232,2007-11-08,0h28m19.966s,-0d03m28.76s,14,12,2,1495,324,325
SDSS-II SN 20257,2007-10-20,21h34m28.32s,-0d08m51.2448s,450,262,188,1521,1063,267
SDSS-II SN 20262,2007-09-05,23h36m15.12s,-0d02m34.512s,12,8,4,1422,15,15
SDSS-II SN 20267,2007-10-31,0h35m12.914s,-0d07m08.93s,24,22,2,1491,10,10
SDSS-II SN 20272,2007-10-20,1h08m52.422s,-0d01m16.01s,3,2,1,1474,21,21
SDSS-II SN 20276,2007-11-01,2h18m15.164s,-0d06m50.55s,6,2,4,1438,358,358
SDSS-II SN 20278,2007-10-20,2h27m34.04s,-0d10m54s,65,59,6,1092,360,19
SDSS-II SN 20300,2007-10-15,2h21m15.576s,0d25m28.301s,4,2,2,1421,375,375
SDSS-II SN 20316,2007-10-20,1h11m42.408s,0d49m30.295s,9,6,3,1474,1115,2
SDSS-II SN 20323,2007-10-20,20h53m42.96s,1d08m41.892s,12,6,6,439,639,305
SDSS-II SN 20336,2007-11-01,2h27m58.176s,1d10m34.428s,10,2,8,1438,357,357
SDSS-II SN 20400,2007-10-31,22h30m07.667s,-1d09m15.15s,14,12,2,1176,323,323
SDSS-II SN 20405,2007-09-05,22h53m46.08s,-1d08m16.188s,10,2,8,327,1454,3
SDSS-II SN 20408,2007-10-19,21h14m27.84s,-0d45m50.76s,23,4,19,398,1391,296
SDSS-II SN 20411,2007-10-19,22h06m34.32s,-0d42m32.742s,10,4,6,401,709,328
SDSS-II SN 20431,2007-10-29,21h01m50.16s,0d29m08.466s,23,13,10,1526,634,286
SDSS-II SN 20435,2007-10-21,21h30m15.817s,0d33m31.3s,613,348,265,1522,1062,266
SDSS-II SN 20447,2007-10-19,23h57m18.416s,0d34m15.24s,6,4,2,1459,21,22
SDSS-II SN 20467,2007-10-21,1h20m04.75s,0d54m48.6s,12,6,6,1120,350,10
SDSS-II SN 20476,2007-11-04,21h41m40.81s,0d50m20.3s,20,16,4,1526,309,292
SDSS-II SN 20491,2007-10-19,23h23m55.585s,-1d11m35.74s,14,4,10,1516,736,311
SDSS-II SN 20501,2007-10-09,1h50m12.528s,-1d12m04.284s,8,4,4,1100,376,377
SDSS-II SN 20514,2007-10-12,1h32m18.253s,-0d45m18.9s,10,6,4,1111,372,366
SDSS-II SN 20541,2007-11-04,21h25m00.96s,-0d16m05.682s,12,10,2,458,291,292
SDSS-II SN 20545,2007-11-04,22h01m00s,-0d25m26.35s,17,6,11,438,692,278
SDSS-II SN 20553,2007-10-29,23h43m10.133s,-0d19m51.78s,10,8,2,409,305,305
SDSS-II SN 20557,2007-10-19,0h59m02.8s,-0d18m34.02s,12,6,6,1473,9,3
SDSS-II SN 20558,2007-10-09,1h01m14.856s,-0d25m19.6104s,10,4,6,1463,19,13
SDSS-II SN 20572,2007-10-29,20h59m31.44s,0d08m08.2284s,8,4,4,1526,627,309
SDSS-II SN 20578,2007-10-14,21h58m20.4s,0d10m59.3s,22,10,12,417,325,284
SDSS-II SN 20588,2007-10-06,0h14m26.844s,0d05m31.29s,18,4,14,385,389,344
SDSS-II SN 20590,2007-10-31,0h27m39.9384s,0d12m43.74s,10,8,2,1134,332,333
SDSS-II SN 20591,2007-10-12,1h05m50.568s,0d06m49.813s,8,4,4,1466,16,16
SDSS-II SN 20592,2007-10-12,1h17m57.168s,0d09m58s,10,4,6,20,17,10
SDSS-II SN 20596,2007-10-29,1h46m47.544s,0d07m03.9612s,6,4,2,1120,356,356
SDSS-II SN 20601,2007-10-09,3h29m22.104s,0d06m35.795s,6,2,4,302,436,78
SDSS-II SN 20608,2007-10-08,23h10m23.04s,-1d00m07.704s,16,14,2,1506,367,368
SDSS-II SN 20613,2007-10-30,21h23m56.88s,-0d33m46.26s,16,10,6,453,296,260
SDSS-II SN 20619,2007-09-16,22h23m08.4s,-0d25m48.522s,2,1,1,1118,1487,1488
SDSS-II SN 20624,2007-10-31,0h18m38.4768s,-0d37m01.128s,28,16,12,1134,363,333
SDSS-II SN 20678,2007-11-02,1h10m01.94s,1d13m48.4s,6,4,2,1487,333,334
SDSS-II SN 20685,2007-10-20,0h57m10.621s,1d14m24.66s,14,8,6,1474,351,336
SDSS-II SN 20690,2007-11-02,21h58m57.84s,1d10m29.892s,13,8,5,1182,679,321
SDSS-II SN 20709,2007-11-08,0h15m39.052s,-0d10m00.27s,16,4,12,418,355,311
SDSS-II SN 20719,2007-10-20,2h15m29.798s,-0d05m03.05s,12,2,10,1426,396,370
SDSS-II SN 20721,2007-11-02,21h32m44.375s,-0d37m19.62s,320,206,114,1534,1050,254
SDSS-II SN 20722,2007-11-08,21h41m01.44s,0d42m05.5s,14,12,2,450,287,288
SDSS-II SN 20727,2007-11-02,2h52m14.568s,-0d10m19.326s,11,2,9,14,723,383
SDSS-II SN 20744,2007-11-08,23h06m11.834s,0d21m32.27s,11,9,2,1536,336,337
SDSS-II SN 20745,2007-10-20,23h54m52.08s,0d16m44.501s,8,4,4,1460,320,24
SDSS-II SN 20750,2007-11-02,1h32m33.761s,0d24m46.24s,8,6,2,1124,349,350
SDSS-II SN 20759,2007-10-20,3h45m19.872s,0d19m45.887s,4,2,2,1419,413,414
SDSS-II SN 20787,2007-10-19,3h22m02.607s,-0d26m32.81s,18,2,16,1424,423,2
SDSS-II SN 20791,2007-10-29,21h11m47.493s,-0d23m09.28s,14,4,10,408,634,286
SDSS-II SN 20805,2007-10-31,21h16m18.96s,-0d41m02.202s,20,4,16,410,1379,313
SDSS-II SN 20815,2007-11-02,3h31m18.912s,0d42m41.288s,12,8,4,1436,396,54
SDSS-II SN 20825,2007-10-29,22h43m09.12s,0d33m56.797s,9,4,5,411,701,338
SDSS-II SN 20828,2007-11-04,21h42m09.231s,0d57m44.93s,6,4,2,1526,309,310
SDSS-II SN 20830,2007-11-04,22h51m38.16s,0d55m18.268s,8,6,2,1179,339,340
SDSS-II SN 20842,2007-10-19,0h26m52.528s,-1d11m40.09s,10,6,4,1475,8,9
SDSS-II SN 20870,2007-10-19,0h57m59.457s,-0d41m09.43s,18,8,10,1475,375,3
SDSS-II SN 20877,2007-10-19,0h39m08.8152s,0d30m51.037s,12,10,2,1084,328,329
SDSS-II SN 20891,2007-11-04,3h52m38.184s,0d31m22.958s,7,2,5,1434,755,408
SDSS-II SN 20896,2007-10-21,0h02m54.38s,0d56m23.1s,12,10,2,1461,17,17
SDSS-II SN 20915,2007-11-04,3h02m19.272s,-1d03m46.404s,8,2,6,13,410,56
SDSS-II SN 20916,2007-10-21,1h18m21.04s,1d01m27.91s,12,6,6,1120,350,10
SDSS-II SN 20917,2007-11-04,3h04m16.608s,-1d08m44.376s,8,4,4,1437,365,56
SDSS-II SN 20923,2007-10-12,1h55m48.744s,-0d48m35.802s,6,4,2,1102,374,374
SDSS-II SN 20926,2007-11-04,2h47m15.48s,-0d43m31.044s,8,2,6,11,1479,369
SDSS-II SN 20932,2007-10-17,2h08m39.888s,0d57m40.338s,16,6,10,1423,372,371
SDSS-II SN 20936,2007-11-04,3h32m16.08s,0d50m52.231s,12,8,4,1438,394,52
SDSS-II SN 20953,2007-10-29,22h46m23.35s,-0d15m04.43s,6,5,1,1175,708,709
SDSS-II SN 20961,2007-11-04,0h37m54.7s,-0d19m15.0348s,14,12,2,56,6,6
SDSS-II SN 20969,2007-10-29,1h40m21.768s,-0d21m12.6s,6,4,2,34,353,354
SDSS-II SN 20971,2007-11-04,1h56m10.06s,-0d12m57.5s,14,4,10,1125,1131,352
SDSS-II SN 20998,2007-11-04,1h12m05.592s,0d09m35.53s,12,3,9,1489,1419,1058
SDSS-II SN 21001,2007-11-04,1h33m53.736s,0d10m00.1812s,8,6,2,1126,347,348
SDSS-II SN 21013,2007-10-31,2h01m12.288s,-0d56m02.1408s,8,4,4,1121,356,356
SDSS-II SN 21015,2007-11-08,2h33m28.879s,-0d58m53.32s,12,4,8,1472,377,360
SDSS-II SN 21019,2007-11-01,2h29m49.632s,-0d26m41.298s,62,56,6,1104,354,7
SDSS-II SN 21023,2007-10-19,2h27m13.824s,-0d02m18.5208s,73,67,6,1091,361,20
SDSS-II SN 21027,2007-11-12,1h58m06.936s,0d19m22.058s,7,4,3,1133,710,710
SDSS-II SN 21060,2007-11-02,21h32m40.528s,0d18m49.45s,566,328,238,1534,1392,254
SDSS-II SN 21069,2007-10-20,23h16m14.64s,-0d50m18.5s,8,6,2,1517,354,355
SDSS-II SN 21161,2007-09-14,20h47m20.88s,0d03m12.72s,14,7,7,1488,678,312
SDSS-II SN 21185,2007-11-04,22h43m22.56s,-0d43m02.766s,10,4,6,417,1372,331
SDSS-II SN 21306,2007-10-29,23h31m41.598s,0d05m29.43s,383,311,72,1476,726,301
SDSS-II SN 21307,2007-10-14,23h35m29.76s,0d07m39.4s,13,11,2,1461,329,329
SDSS-II SN 21347,2007-11-04,1h38m36.67s,-1d03m34.9s,10,6,4,1126,349,350
SDSS-II SN 21351,2007-09-19,2h33m25.104s,-1d04m48.036s,12,4,8,1422,427,410
SDSS-II SN 21361,2007-11-04,3h46m37.992s,-0d48m38.808s,4,2,2,1093,408,408
SDSS-II SN 21381,2007-11-04,3h26m39.624s,-0d13m01.776s,6,2,4,1440,407,407
SDSS-II SN 21385,2007-10-19,23h50m48s,0d11m28.4s,10,8,2,399,321,322
SDSS-II SN 21388,2007-11-04,0h12m33.29s,0d03m05.8s,14,4,10,414,353,315
SDSS-II SN 21389,2007-11-04,0h14m15.36s,0d01m41.13s,18,4,14,414,360,315
SDSS-II SN 21401,2007-10-21,3h14m36.696s,0d06m11s,9,2,7,1426,428,40
SDSS-II SN 21402,2007-11-04,3h24m27.672s,0d02m04.999s,8,2,6,1440,407,406
SDSS-II SN 21404,2007-11-04,3h29m38.808s,0d04m55s,6,2,4,328,410,52
SDSS-II SN 21405,2007-10-21,3h34m34.176s,0d03m22.4s,6,4,2,1424,411,412
SDSS-II SN 21406,2007-09-19,3h39m29.88s,0d00m25.3s,12,2,10,282,805,453
SDSS-II SN 21451,2007-11-04,1h49m03.096s,0d32m43.242s,10,2,8,18,351,2
SDSS-II SN 21465,2007-10-30,21h32m13.92s,0d39m50.335s,555,324,231,1508,1395,257
SDSS-II SN 21482,2007-11-08,21h41m18.48s,-0d05m46.0572s,14,6,8,447,286,259
SDSS-II SN 21487,2007-11-12,22h41m07.44s,-0d12m41.2s,10,4,6,425,1364,323
SDSS-II SN 2149,2005-09-03,1h09m47.489s,-0d35m18.36s,12,2,10,697,1893,764
SDSS-II SN 21494,2007-11-08,22h43m11.04s,0d18m15.95s,15,4,11,421,1368,327
SDSS-II SN 21577,2007-11-02,1h56m13.264s,-0d31m54.32s,14,4,10,1123,1133,354
SDSS-II SN 21582,2007-10-15,2h25m01.608s,-0d30m55.098s,5,1,4,708,365,3
SDSS-II SN 21589,2007-11-12,1h34m18.288s,-0d01m20.1468s,8,6,2,1134,339,340
SDSS-II SN 21591,2007-09-03,1h57m22.272s,-0d06m05.112s,8,4,4,1063,413,414
SDSS-II SN 2162,2005-09-03,1h01m46.296s,-0d08m01.12s,8,2,6,697,776,764
SDSS-II SN 21648,2007-11-02,2h08m18.984s,0d25m25.57s,10,4,6,1123,355,355
SDSS-II SN 21663,2007-11-02,1h58m52.704s,0d00m00.8s,11,4,7,1123,720,354
SDSS-II SN 21764,2007-11-04,1h28m01.536s,-0d24m00.792s,13,4,9,1134,720,326
SDSS-II SN 21813,2007-11-12,22h39m05.252s,1d11m05.08s,11,4,7,1189,1430,305
SDSS-II SN 21858,2007-11-02,0h05m20.897s,1d03m41.76s,12,10,2,1473,5,5
SDSS-II SN 21874,2007-11-05,3h35m52.08s,-0d32m11.9292s,6,4,2,1439,396,397
SDSS-II SN 21875,2007-11-08,2h13m49.968s,0d45m46.87s,8,2,6,1,360,351
SDSS-II SN 21884,2007-11-08,3h26m14.52s,-0d06m49.878s,6,2,4,1444,403,403
SDSS-II SN 21885,2007-11-17,23h04m27.36s,0d19m06.3012s,8,4,4,1192,327,327
SDSS-II SN 21888,2007-11-12,1h15m42.94s,0d14m07.7s,18,10,8,51,1411,317
SDSS-II SN 21889,2007-10-23,1h56m19.536s,0d20m40.477s,11,4,7,1113,1140,363
SDSS-II SN 2355,2005-09-03,0h06m18.6144s,-0d27m58.0284s,14,2,12,683,1121,759
SDSS-II SN 2532,2005-09-14,1h50m59.4s,-0d14m03.04s,8,4,4,345,1132,1132
SDSS-II SN 2537,2005-09-14,3h23m41.256s,-0d17m09.2292s,6,2,4,659,1187,1187
SDSS-II SN 2551,2005-09-09,23h50m42.48s,-1d09m50.292s,20,12,8,747,770,726
SDSS-II SN 2621,2005-09-09,1h01m22.536s,-1d07m44.976s,20,4,16,703,1117,396
SDSS-II SN 2639,2005-09-13,22h01m51.415s,0d39m51.77s,10,6,4,402,1103,10
SDSS-II SN 2784,2005-09-15,1h52m18.102s,-0d02m30.19s,12,4,8,346,1908,1131
SDSS-II SN 2806,2005-09-03,3h01m04.06s,0d16m25.1s,8,2,6,645,1201,1175
SDSS-II SN 2808,2005-09-03,3h25m50.256s,0d17m31.96s,6,2,4,648,1199,1199
SDSS-II SN 2855,2005-09-14,1h04m42.068s,-0d21m22.88s,12,2,10,708,774,753
SDSS-II SN 2871,2005-09-14,0h37m23.405s,-1d05m12.63s,10,2,8,697,774,752
SDSS-II SN 3161,2005-10-01,21h14m58.56s,1d08m12.228s,16,3,13,413,1387,1071
SDSS-II SN 3172,2005-09-13,22h22m40.56s,-0d38m11.2524s,2,1,1,385,2220,2221
SDSS-II SN 3175,2005-09-03,2h58m28.152s,-0d58m13.908s,10,2,8,645,1202,1174
SDSS-II SN 3180,2005-09-26,0h28m26.82s,0d18m43.384s,8,2,6,369,1097,740
SDSS-II SN 3195,2005-09-22,0h34m40.422s,0d14m39.58s,12,2,10,722,731,403
SDSS-II SN 3205,2005-09-22,0h54m05.368s,0d18m47.16s,8,2,6,718,779,732
SDSS-II SN 3206,2005-09-09,0h54m18.598s,0d25m05.61s,8,2,6,705,792,745
SDSS-II SN 3225,2005-09-15,1h33m31.525s,0d18m40.7s,8,4,4,346,1127,751
SDSS-II SN 3323,2005-09-15,3h22m58.08s,0d25m19.88s,10,2,8,660,1186,1186
SDSS-II SN 3402,2005-09-12,22h11m35.04s,0d31m37.146s,52,8,44,401,1805,11
SDSS-II SN 3417,2005-09-23,20h57m06.25s,0d58m41.7s,5,4,1,760,1393,1393
SDSS-II SN 3421,2005-09-23,21h02m56.64s,0d51m01.728s,25,7,18,760,1400,318
SDSS-II SN 3426,2005-09-21,22h47m35.944s,0d36m55.89s,12,6,6,407,1113,357
SDSS-II SN 3475,2005-10-11,0h02m05.614s,-0d09m02.3184s,8,2,6,721,721,720
SDSS-II SN 3506,2005-09-22,22h25m00.176s,-0d58m41.23s,2,1,1,394,2211,2212
SDSS-II SN 3508,2005-09-15,1h03m17.71s,-0d10m44.4s,16,2,14,709,773,752
SDSS-II SN 3535,2005-09-13,2h56m28.13s,-0d08m00.5s,16,2,14,297,1191,52
SDSS-II SN 3543,2005-09-21,20h47m20.16s,0d03m12.41s,14,7,7,765,1401,1035
SDSS-II SN 3560,2005-09-10,0h03m04.466s,0d47m49.99s,16,2,14,690,788,751
SDSS-II SN 3565,2005-09-22,0h10m21.035s,0d42m33.79s,22,2,20,702,1104,740
SDSS-II SN 3593,2005-09-13,1h18m27.987s,0d43m56.28s,12,4,8,352,1118,441
SDSS-II SN 3669,2005-09-10,23h19m01.92s,-0d50m22.848s,14,4,10,746,1150,1099
SDSS-II SN 3674,2005-09-21,23h59m09.989s,0d09m46.71s,8,2,6,701,779,397
SDSS-II SN 3780,2005-09-25,0h22m10.3536s,0d32m28.439s,31,30,1,751,1485,1485
SDSS-II SN 3811,2005-09-14,0h54m49.1s,0d25m46.72s,6,2,4,708,754,741
SDSS-II SN 3881,2005-09-10,23h27m31.611s,-0d26m30.4s,11,1,10,23,1508,1080
SDSS-II SN 3889,2005-09-22,0h30m45.34s,-0d26m18.24s,16,4,12,718,767,404
SDSS-II SN 3945,2005-09-14,23h04m02.4s,-0d16m59.3s,7,5,2,691,1121,1122
SDSS-II SN 3959,2005-09-25,3h00m23.472s,0d30m43.06s,8,2,6,667,1179,1153
SDSS-II SN 3970,2005-10-12,0h02m46.29s,-0d21m51.4476s,8,2,6,722,722,720
SDSS-II SN 3975,2005-09-22,1h59m17.048s,0d12m13.37s,11,6,5,352,1491,63
SDSS-II SN 3983,2005-09-27,0h29m06.211s,-0d15m23.59s,10,4,6,723,726,726
SDSS-II SN 4019,2005-09-26,0h05m02.863s,1d08m46.66s,14,2,12,706,772,735
SDSS-II SN 4028,2005-09-24,0h44m03.359s,1d14m33.23s,8,2,6,720,1083,763
SDSS-II SN 4048,2005-09-24,0h23m39.6456s,0d47m00.3624s,65,52,13,750,1486,742
SDSS-II SN 4054,2005-09-14,3h20m22.536s,0d11m43.962s,10,2,8,659,1187,1187
SDSS-II SN 4079,2005-09-22,1h56m49.611s,0d45m14.83s,16,6,10,352,1138,1124
SDSS-II SN 4110,2005-09-14,0h06m38.007s,-1d11m48.36s,8,4,4,737,784,749
SDSS-II SN 4117,2005-09-25,0h21m59.93s,-1d14m38.184s,6,4,2,747,765,766
SDSS-II SN 4129,2005-09-25,0h51m58.817s,-1d13m04.94s,4,2,2,721,755,755
SDSS-II SN 4175,2005-09-25,2h12m41.616s,-1d10m30.936s,8,4,4,355,1123,420
SDSS-II SN 4181,2005-09-21,2h31m16.27s,-1d07m51.6s,8,2,6,694,1141,45
SDSS-II SN 4206,2005-09-24,23h38m18.522s,-0d29m11.3s,8,4,4,711,1068,364
SDSS-II SN 4211,2005-09-13,0h02m02.191s,-0d31m52.7412s,14,2,12,693,751,748
SDSS-II SN 4229,2005-09-22,0h23m10.49s,0d18m49.77s,28,27,1,748,1488,1488
SDSS-II SN 4236,2005-09-24,0h07m37.36s,-1d01m06s,12,6,6,747,1100,739
SDSS-II SN 4307,2005-09-21,1h59m51s,0d56m58.87s,11,6,5,351,1492,64
SDSS-II SN 4311,2005-09-25,2h08m31.43s,1d01m11.9s,8,2,6,671,1123,1123
SDSS-II SN 4313,2005-09-25,2h24m36.102s,1d02m05.07s,10,2,8,671,1125,35
SDSS-II SN 4360,2005-09-14,1h18m37.42s,0d54m56.8s,12,4,8,353,1117,440
SDSS-II SN 4361,2005-09-13,0h21m21.298s,-0d37m06.6576s,16,2,14,356,1112,367
SDSS-II SN 4455,2005-09-26,3h28m37.497s,-0d03m37.67s,10,2,8,671,1179,821
SDSS-II SN 4540,2005-09-15,3h35m56.232s,-0d29m45.78s,6,2,4,658,1177,451
SDSS-II SN 4557,2005-09-26,1h55m10.8s,0d16m04.3572s,18,4,14,356,1900,1120
SDSS-II SN 4558,2005-09-13,1h59m32.51s,0d17m24.3s,11,6,5,343,1500,72
SDSS-II SN 4612,2005-09-21,0h54m01.73s,-0d50m09.8s,22,8,14,717,1494,741
SDSS-II SN 4639,2005-09-27,1h57m25.824s,-0d45m26.1108s,8,4,4,357,1119,1120
SDSS-II SN 4651,2005-09-27,2h29m30.182s,-0d44m49.97s,60,52,8,339,1112,751
SDSS-II SN 4682,2005-09-24,1h26m12.169s,0d48m39.38s,6,4,2,363,738,739
SDSS-II SN 4714,2005-09-22,2h28m36.57s,-0d12m19.8s,60,56,4,334,777,756
SDSS-II SN 4757,2005-09-15,2h16m35.208s,-1d00m56.3s,6,4,2,700,1124,1125
SDSS-II SN 4808,2005-10-01,2h20m16.653s,0d24m41.18s,4,2,2,677,1119,1119
SDSS-II SN 4857,2005-09-13,1h31m30.984s,-0d09m18.396s,12,4,8,352,1129,387
SDSS-II SN 4978,2005-10-01,23h22m38.517s,-0d25m44.82s,18,6,12,767,1486,1059
SDSS-II SN 5178,2005-09-15,3h29m06.264s,0d42m49.18s,7,2,5,660,1534,834
SDSS-II SN 5197,2005-09-03,3h45m56.832s,0d40m25.774s,6,2,4,642,1197,1194
SDSS-II SN 5199,2005-10-01,23h15m10.196s,-0d59m41.59s,8,4,4,768,1103,361
SDSS-II SN 5209,2005-09-26,23h59m39.12s,-1d00m58.5s,18,2,16,706,775,393
SDSS-II SN 5230,2005-10-01,22h19m10.32s,0d50m19.5s,213,114,99,761,2202,344
SDSS-II SN 5247,2005-10-01,1h33m51.846s,-0d55m25.04s,10,4,6,370,1113,369
SDSS-II SN 5292,2005-09-26,3h04m03.48s,-0d51m24.228s,8,2,6,668,1179,1134
SDSS-II SN 5378,2005-10-03,2h30m56.905s,-1d15m07.25s,8,2,6,706,1129,33
SDSS-II SN 5468,2005-09-13,22h50m07.38s,0d24m17.5s,12,6,6,399,1121,365
SDSS-II SN 5473,2005-10-01,23h38m56.808s,0d23m00.55s,8,4,4,718,719,359
SDSS-II SN 5486,2005-10-05,22h12m59.517s,-0d24m43.2s,56,9,47,424,1819,1051
SDSS-II SN 5498,2005-10-05,22h43m52.08s,-0d42m52.9596s,12,4,8,421,2132,343
SDSS-II SN 5590,2005-09-13,23h46m41.52s,-0d52m22s,14,2,12,695,1079,367
SDSS-II SN 5595,2005-10-11,20h52m04.56s,-0d06m08.892s,15,10,5,785,1374,300
SDSS-II SN 5659,2005-10-11,23h30m33.84s,-0d02m18.7188s,167,109,58,764,1474,8
SDSS-II SN 5690,2005-10-11,0h47m08.904s,-0d54m47.52s,6,2,4,737,726,713
SDSS-II SN 5691,2005-10-11,0h24m36.5664s,-0d10m05.1852s,10,4,6,737,749,725
SDSS-II SN 5702,2005-10-01,0h50m20.002s,-0d55m08.62s,4,2,2,727,749,749
SDSS-II SN 5731,2005-09-26,0h45m21.26s,-0d32m39.9s,8,2,6,722,735,728
SDSS-II SN 5735,2005-10-01,20h46m38.135s,0d39m02.29s,34,7,27,775,1418,1025
SDSS-II SN 5804,2005-10-05,22h32m32.16s,0d59m13.09s,2,1,1,406,2198,2198
SDSS-II SN 5869,2005-09-27,1h49m28.896s,-0d46m36.7248s,8,4,4,358,1118,1119
SDSS-II SN 5877,2005-10-12,20h44m26.88s,0d32m27.82s,16,6,10,457,1726,295
SDSS-II SN 5890,2005-10-05,22h10m03.759s,0d36m33.13s,57,9,48,424,1782,354
SDSS-II SN 5897,2005-10-12,2h32m39.33s,-0d48m14.44s,16,2,14,715,1134,24
SDSS-II SN 5917,2005-10-12,0h24m08.866s,-0d15m18.13s,10,4,6,738,748,724
SDSS-II SN 5925,2005-09-27,1h44m39.02s,-1d08m45.8s,6,4,2,358,1118,1119
SDSS-II SN 5963,2005-10-12,0h44m19.45s,0d28m46.2s,12,2,10,738,745,696
SDSS-II SN 5978,2005-10-22,1h44m38.98s,0d55m18.8s,10,4,6,383,1093,715
SDSS-II SN 5993,2005-09-27,1h58m43.77s,0d02m56.7s,13,4,9,357,1486,58
SDSS-II SN 6055,2005-09-26,2h31m37.548s,-0d53m45.55s,12,2,10,699,1136,40
SDSS-II SN 6120,2005-10-11,22h12m34.412s,-0d03m26.33s,101,13,88,430,1791,1044
SDSS-II SN 6121,2005-10-20,1h48m00.62s,0d18m15.48s,6,4,2,381,1095,1095
SDSS-II SN 6210,2005-10-11,21h59m10.08s,0d50m13.6s,17,10,7,430,1431,1073
SDSS-II SN 6225,2005-10-20,0h01m09s,-1d00m01.4s,8,2,6,730,718,711
SDSS-II SN 6274,2005-10-22,2h12m36.096s,0d06m03.2436s,8,2,6,698,1123,1098
SDSS-II SN 6275,2005-10-20,2h18m21.557s,0d01m48.04s,6,2,4,696,1100,1100
SDSS-II SN 6300,2005-11-13,2h29m38.776s,-0d33m00.34s,62,54,8,386,1065,704
SDSS-II SN 6362,2005-10-20,3h19m29.832s,-0d55m15.996s,10,2,8,695,1151,731
SDSS-II SN 6469,2005-11-29,21h27m53.28s,-0d10m13.5696s,72,18,54,831,1740,242
SDSS-II SN 6491,2005-10-12,1h06m35.58s,0d32m26.7s,22,2,20,736,1812,725
SDSS-II SN 6496,2005-10-21,20h44m15.84s,0d03m07.333s,17,9,8,795,1717,1005
SDSS-II SN 6501,2005-10-14,21h00m37.652s,0d07m53.38s,14,7,7,781,1372,1054
SDSS-II SN 6530,2005-10-12,0h57m18.984s,0d01m16.88s,8,2,6,736,747,725
SDSS-II SN 6556,2005-10-21,0h28m03.79s,-1d04m27.1s,14,4,10,747,751,715
SDSS-II SN 6618,2005-10-20,2h47m40.72s,0d57m51.12s,8,2,6,724,1109,729
SDSS-II SN 6641,2005-10-12,20h45m45.12s,-0d13m17.2668s,14,7,7,786,1380,1014
SDSS-II SN 6654,2005-09-21,21h31m37.44s,-0d17m10.6296s,565,192,373,762,2164,311
SDSS-II SN 6683,2005-10-23,21h48m51.36s,0d36m45.3s,6,4,2,784,1058,1059
SDSS-II SN 6696,2005-10-21,22h36m19.04s,0d28m45.3s,3,1,2,422,2182,2182
SDSS-II SN 6709,2005-10-21,23h35m58.286s,0d36m49.19s,8,4,4,738,699,339
SDSS-II SN 6807,2005-11-02,22h32m16.56s,-1d08m44.016s,2,1,1,434,2170,2171
SDSS-II SN 6813,2005-10-12,1h49m04.872s,0d03m26s,6,4,2,373,1103,1103
SDSS-II SN 6816,2005-10-22,2h18m04.929s,0d06m43.56s,6,2,4,698,1098,1098
SDSS-II SN 6831,2005-10-20,2h20m02.696s,0d43m17.33s,4,2,2,696,1100,1100
SDSS-II SN 6851,2005-10-23,3h28m25.087s,-0d02m54.71s,8,2,6,698,1149,794
SDSS-II SN 6861,2005-10-21,23h17m43.68s,-1d06m49.39s,6,4,2,788,341,341
SDSS-II SN 6873,2005-10-20,3h30m10.44s,0d46m18.05s,7,2,5,695,1499,799
SDSS-II SN 6877,2005-09-28,3h30m01.56s,0d37m16.5s,7,2,5,673,1521,821
SDSS-II SN 6883,2005-10-21,21h18m14.4s,0d52m58.465s,11,7,4,433,2113,1061
SDSS-II SN 6889,2005-10-12,21h46m52.79s,0d54m34.21s,12,6,6,773,1069,309
SDSS-II SN 6895,2005-10-23,22h00m46.29s,0d55m41.68s,13,8,5,442,1419,1064
SDSS-II SN 6896,2005-10-23,22h01m00.898s,1d01m00.53s,27,12,15,442,1419,295
SDSS-II SN 6913,2005-10-23,23h00m59.966s,1d02m12.11s,12,8,4,437,1082,340
SDSS-II SN 696,2005-09-03,23h36m43.2s,-1d01m13.584s,10,4,6,690,746,385
SDSS-II SN 7051,2005-10-12,23h54m10.08s,0d01m30.1s,8,2,6,722,1058,376
SDSS-II SN 7056,2005-10-21,0h09m23.062s,0d08m11.893s,20,2,18,731,1075,711
SDSS-II SN 7099,2005-10-20,22h51m33.17s,1d10m02.5s,8,6,2,434,1084,1085
SDSS-II SN 7119,2005-10-25,21h03m57.36s,-0d04m13.2348s,7,2,5,435,1048,313
SDSS-II SN 7194,2005-10-14,2h28m38.59s,-0d28m09.6s,62,54,8,356,1095,734
SDSS-II SN 7195,2005-10-30,2h28m58.49s,-0d32m00.8s,62,54,8,372,1079,718
SDSS-II SN 7365,2005-09-23,23h29m16.08s,0d34m47.3s,38,19,19,759,1493,3
SDSS-II SN 7373,2005-10-28,23h31m13.177s,0d35m17.9s,53,22,31,745,1458,312
SDSS-II SN 7374,2005-10-23,23h32m03.06s,0d37m12.98s,250,105,145,740,1460,316
SDSS-II SN 7413,2005-09-09,1h00m10.891s,0d28m28.99s,6,2,4,703,792,758
SDSS-II SN 7457,2005-11-02,23h23m36.756s,-0d22m19.85s,18,6,12,799,1454,1027
SDSS-II SN 7479,2005-10-31,0h28m54.194s,-0d24m34.13s,10,4,6,757,692,692
SDSS-II SN 7502,2005-10-12,1h32m32.38s,-0d22m07.7s,8,4,4,381,1095,358
SDSS-II SN 7594,2005-09-21,22h58m36.24s,0d53m57.383s,12,8,4,405,1114,372
SDSS-II SN 7600,2005-10-28,23h10m27.36s,-1d06m27.68s,14,10,4,796,1077,350
SDSS-II SN 7644,2005-11-23,23h35m44.41s,0d52m06.02s,8,4,4,771,666,306
SDSS-II SN 7663,2005-10-26,0h52m45.802s,0d55m31.58s,10,2,8,752,1076,698
SDSS-II SN 7699,2005-10-21,0h24m57.293s,-1d12m56.51s,10,4,6,747,736,715
SDSS-II SN 7701,2005-10-26,0h26m04.076s,-1d13m43.48s,10,4,6,752,731,710
SDSS-II SN 7713,2005-10-26,0h46m38.784s,-1d15m21.6s,6,2,4,752,711,698
SDSS-II SN 7717,2005-10-26,0h57m45.72s,-1d13m56.4s,10,2,8,752,1070,1060
SDSS-II SN 7725,2005-10-23,22h30m53.28s,-0d42m22.4244s,2,1,1,424,2180,2181
SDSS-II SN 773,2005-09-03,1h38m30.792s,-0d51m46.008s,12,4,8,334,1141,752
SDSS-II SN 7736,2005-10-23,21h51m00.72s,0d07m04.9548s,13,11,2,796,1060,1060
SDSS-II SN 7780,2005-10-27,20h40m52.08s,-0d05m07.6452s,14,4,10,472,1711,280
SDSS-II SN 779,2005-09-15,1h46m41.7s,-1d01m14.1s,6,4,2,346,1130,1131
SDSS-II SN 7794,2005-10-26,0h22m02.136s,0d04m29.65s,31,30,1,782,1454,1454
SDSS-II SN 7802,2005-10-27,23h02m18.269s,0d43m45.03s,7,5,2,441,1078,1078
SDSS-II SN 7803,2005-10-20,23h04m20.748s,0d41m25.76s,7,5,2,434,1085,1085
SDSS-II SN 7822,2005-10-20,23h14m59.52s,-0d00m25.956s,8,4,4,787,1436,1086
SDSS-II SN 7824,2005-10-27,23h15m15.134s,-0d04m50.85s,8,4,4,794,1429,1079
SDSS-II SN 7835,2005-10-20,0h05m49.9776s,-0d04m49.9908s,14,2,12,730,748,712
SDSS-II SN 7851,2005-10-20,0h08m39.785s,0d42m04.464s,30,2,28,730,1080,330
SDSS-II SN 7882,2005-10-21,1h08m13.023s,0d10m23.9s,5,1,4,745,1803,1802
SDSS-II SN 7884,2005-10-12,1h27m04.184s,0d07m24.49s,6,4,2,381,722,723
SDSS-II SN 7954,2005-11-03,22h10m42.481s,0d20m51.99s,57,9,48,453,1753,325
SDSS-II SN 7986,2005-10-20,22h10m29.04s,-0d26m15.216s,52,9,43,439,1765,1036
SDSS-II SN 8004,2005-10-27,23h10m06.84s,-0d33m28.72s,8,6,2,793,1079,1079
SDSS-II SN 8062,2005-10-21,23h11m54.479s,0d04m37.45s,12,10,2,787,1085,1085
SDSS-II SN 8092,2005-10-14,3h20m36.286s,0d05m38.26s,10,2,8,689,1157,1157
SDSS-II SN 8114,2005-10-20,23h28m51.992s,0d13m42.29s,298,223,75,786,1466,0
SDSS-II SN 8138,2005-10-30,0h45m51.98s,0d22m41s,8,2,6,756,734,706
SDSS-II SN 8160,2005-10-20,2h15m03.67s,-1d06m01.8s,6,4,2,735,1089,1090
SDSS-II SN 8165,2005-10-26,3h20m54.07s,-1d06m33.8s,10,2,8,701,1145,725
SDSS-II SN 8216,2005-10-30,22h05m04.677s,-0d03m07.91s,18,5,13,449,1428,287
SDSS-II SN 8254,2005-11-03,23h24m39.36s,0d49m11.9s,23,10,13,800,1452,1026
SDSS-II SN 8280,2005-10-27,0h34m17.558s,0d47m44.02s,18,2,16,757,703,368
SDSS-II SN 8290,2005-11-09,3h41m56.424s,1d10m04.08s,4,2,2,709,1122,1122
SDSS-II SN 8307,2005-10-23,2h26m25.087s,0d47m26.32s,64,4,60,699,1096,2
SDSS-II SN 8327,2005-10-23,3h28m58.176s,0d40m35.8s,7,2,5,698,1496,796
SDSS-II SN 8421,2005-11-01,0h58m04.32s,-0d56m02.9s,18,4,14,758,1092,700
SDSS-II SN 8457,2005-09-28,3h19m16.656s,-0d50m18.726s,10,2,8,673,1173,753
SDSS-II SN 8576,2005-10-20,0h55m27.792s,-0d09m41.2092s,8,2,6,746,751,704
SDSS-II SN 8577,2005-10-27,0h57m11.256s,-0d07m44.922s,8,2,6,751,732,710
SDSS-II SN 8600,2005-10-26,2h57m04.987s,-0d05m32.72s,16,2,14,340,1148,9
SDSS-II SN 8605,2005-10-14,3h24m09.24s,-0d00m10.782s,6,2,4,689,1157,1157
SDSS-II SN 8607,2005-10-31,21h34m20.872s,0d09m07.05s,515,149,366,802,2124,265
SDSS-II SN 8651,2005-10-30,1h54m59.76s,-0d31m22.2312s,5,2,3,391,1086,1086
SDSS-II SN 8662,2005-10-20,2h29m46.44s,-0d28m58.2s,60,54,6,362,1096,728
SDSS-II SN 8700,2005-10-26,2h20m26.326s,0d13m37.88s,2,1,1,702,1094,1094
SDSS-II SN 8730,2005-10-26,2h09m05.88s,-0d40m49.1052s,8,4,4,386,1092,1092
SDSS-II SN 8888,2005-11-03,0h20m39.773s,0d19m13.94s,69,60,9,790,1446,316
SDSS-II SN 8912,2005-11-03,20h58m21.84s,-0d09m38.754s,10,6,4,801,1352,1034
SDSS-II SN 893,2005-09-03,0h21m58.61s,-0d07m54s,71,56,15,729,1507,377
SDSS-II SN 9020,2005-10-25,23h08m27.6s,-0d55m11.6s,12,6,6,793,1080,353
SDSS-II SN 904,2005-09-03,1h24m22.896s,-0d07m29.5788s,6,4,2,342,761,762
SDSS-II SN 9052,2005-10-30,1h24m09.884s,-0d28m58.84s,10,4,6,399,1061,705
SDSS-II SN 9109,2005-10-31,1h45m33.38s,0d51m02.66s,10,4,6,392,1084,706
SDSS-II SN 9132,2005-10-31,1h05m01.259s,0d32m24.43s,18,2,16,755,727,691
SDSS-II SN 9133,2005-11-02,1h06m34.191s,0d27m39.12s,8,2,6,757,725,704
SDSS-II SN 9194,2005-10-21,0h07m32.9568s,-0d47m49.074s,12,2,10,731,1073,712
SDSS-II SN 9239,2005-10-27,0h24m56.071s,-1d03m07.2s,12,4,8,753,732,709
SDSS-II SN 9268,2005-10-30,20h46m44.88s,-0d10m27.264s,18,7,11,804,1708,281
SDSS-II SN 9326,2005-10-30,22h57m15.911s,0d37m42.36s,31,8,23,444,1437,1026
SDSS-II SN 9353,2005-11-01,23h31m08.16s,0d41m57.894s,47,22,25,798,1454,308
SDSS-II SN 9424,2005-10-31,22h17m21.6s,0d05m50.88s,53,4,49,777,2118,329
SDSS-II SN 9458,2005-10-25,2h43m13.968s,-0d09m42.7536s,2,1,1,728,2219,2220
SDSS-II SN 9551,2005-10-26,1h32m55.968s,0d05m01.781s,8,4,4,387,1086,710
SDSS-II SN 9557,2005-10-31,2h00m11.952s,0d01m31.47s,11,4,7,391,1452,1086
SDSS-II SN 9558,2005-10-30,1h03m56.388s,0d22m52.82s,12,2,10,754,728,707
SDSS-II SN 9594,2005-11-07,1h10m51.432s,0d07m18.12s,15,2,13,762,1828,700
SDSS-II SN 9595,2005-10-26,1h12m57.216s,0d08m21.142s,19,2,17,750,2158,707
SDSS-II SN 9704,2005-10-25,23h37m18.96s,-0d33m51.1s,12,4,8,742,1037,333
SDSS-II SN 9817,2005-11-11,0h20m09.122s,0d35m53.65s,16,8,8,781,706,308
SDSS-II SN 986,2005-09-03,23h31m14.88s,1d08m30.408s,10,6,4,739,1106,390
SDSS-II SN 9895,2005-11-02,2h21m03.83s,0d30m15.71s,4,2,2,709,1087,1087
SDSS-II SN 9954,2005-11-05,0h26m20.19s,-0d25m31.6s,8,4,4,762,724,724
SN Primo,2010-10-10,3h32m38.01s,-27d46m39.08s,222,125,97,2526,59,41
SN150G,2004-04-03,12h37m09.5s,62d22m15.5s,211,77,134,65,2531,22
SN2003im,2003-09-30,0h44m59.28s,-8d53m11.5s,4,2,2,9,21,21
SN2003jj,2003-10-22,1h07m58.52s,0d03m01.9s,4,1,3,15,2575,2532
SN2003jk,2003-10-22,1h08m06.17s,0d02m20.6s,5,1,4,15,2575,2532
SN2003jo,2003-10-22,23h25m24.03s,-9d26m00.6s,7,1,6,58,2530,1090
SN2003jr,2003-10-24,1h11m06.23s,0d13m44.2s,11,2,9,17,2572,1445
SN2003ju,2003-10-24,23h27m01.71s,-9d24m04.5s,20,2,18,60,2528,316
SN2003kk,2003-11-15,23h25m36.06s,-9d31m44.7s,12,2,10,82,2506,1066
SN2003kl,2003-11-17,1h09m48.8s,1d00m05.6s,8,1,7,41,2507,314
SN2003ku,2003-11-23,1h08m36.25s,-0d33m20.8s,10,2,8,47,2543,1414
SN2003kv,2003-11-27,2h09m42.52s,-3d46m48.6s,14,2,12,5,2567,1088
SN2003lc,2003-12-26,1h23m25.82s,30d47m14.9s,10,2,8,118,1758,1051
SN2003le,2003-12-13,1h08m08.73s,0d27m09.7s,10,2,8,67,2481,1415
SN2003lf,2003-12-13,1h08m49.81s,-0d44m13.5s,10,2,8,67,2523,1394
SN2003lj,2003-12-15,1h12m10.03s,0d19m51.3s,11,2,9,69,2839,1393
SN2003ll,2003-12-15,2h35m41.19s,-8d06m29.6s,11,2,9,20,2552,311
SN2004at,2004-03-12,10h58m45.18s,59d29m12s,42,2,40,46,1433,311
SN2004bj,2004-04-22,13h16m18.03s,7d02m52.7s,5,2,3,7,1463,740
SN2004bk,2004-04-22,13h37m28.72s,4d06m11.3s,3,1,2,6,2547,2547
SN2004cd,2004-05-14,13h44m50.7s,-0d03m48.3s,4,1,3,2,2191,359
SN2004cn,2004-04-17,12h27m28.109s,42d20m28.6s,4,2,2,21,1048,1049
SN2004co,2004-04-17,13h28m33.99s,41d51m08.3s,5,2,3,14,2525,51
SN2004ey,2004-10-14,21h49m07.81s,0d26m39.2s,6,4,2,410,1432,1433
SN2004fd,2004-10-21,2h43m15.25s,32d25m25.6s,3,2,1,363,1056,1057
SN2004fh,2004-10-09,23h28m27.2s,-8d36m55.2s,16,4,12,35,2177,353
SN2004fj,2004-10-11,1h09m51.07s,0d27m21s,10,2,8,370,2178,1092
SN2004fk,2004-10-11,1h13m35.84s,-0d09m27.6s,14,2,12,370,2538,1087
SN2004fl,2004-10-11,23h26m57.92s,-9d37m19.1s,12,2,10,413,2175,735
SN2004fm,2004-10-11,23h26m58.14s,-9d37m19.4s,13,2,11,413,2175,735
SN2004fn,2004-10-11,23h30m20.12s,-9d58m30.7s,17,4,13,37,2175,351
SN2004fo,2004-10-13,1h13m28.97s,0d35m16.3s,19,2,17,16,2536,1074
SN2004fq,2004-10-13,23h27m45.64s,-8d31m12.8s,22,4,18,39,2173,349
SN2004fu,2004-11-04,20h35m11.54s,64d48m25.7s,6,2,4,128,1029,982
SN2004gs,2004-12-12,8h38m23.851s,17d37m52.85s,8,1,7,279,1171,41
SN2004ha,2004-11-06,2h04m27s,-4d52m46s,71,2,69,29,2201,1802
SN2004hb,2004-11-06,2h08m09.7s,-4d41m51.8s,64,1,63,350,2201,1802
SN2004hd,2004-11-14,2h08m48.21s,-4d26m10.4s,31,1,30,358,2193,1794
SN2004hg,2004-11-16,2h34m55.19s,-8d30m43.6s,13,2,11,25,2215,2
SN2004hh,2004-11-20,2h06m25.01s,-4d38m04s,39,1,38,364,2187,1788
SN2004hk,2004-12-05,23h27m04.38s,-8d38m45.1s,19,4,15,92,2120,296
SN2004hl,2004-12-07,1h13m38.17s,-0d27m39s,18,2,16,427,2121,1030
SN2004hn,2004-12-09,1h13m32.38s,0d37m15.3s,19,2,17,73,2479,1017
SN2004ho,2004-12-09,2h06m16.03s,-3d52m27.7s,15,2,13,383,2192,710
SN2004hp,2004-12-09,2h09m35.52s,-3d46m23.5s,14,2,12,383,2189,710
SN2004hr,2004-12-11,1h08m48.33s,0d00m49.5s,3,1,2,431,1064,1030
SN2004ia,2004-10-08,2h18m02.3s,-0d33m32.4s,4,2,2,319,1477,1478
SN2004id,2004-10-16,0h06m29.64s,-0d28m22.3s,12,2,10,361,1443,1081
SN2004ie,2004-10-16,22h01m46.58s,1d14m12s,17,4,13,69,1791,667
SN2004if,2004-10-16,22h39m08.54s,-0d51m54.6s,13,11,2,66,1432,1433
SN2004ig,2004-10-24,0h05m51.79s,-0d59m45.1s,6,4,2,412,1109,1110
SN2004ij,2004-11-05,1h21m11.54s,-0d55m09.2s,13,4,9,40,2548,1420
SN2004ik,2004-11-05,1h44m55.51s,-0d05m58.1s,10,4,6,32,1454,1066
SN2004il,2004-11-05,3h07m02.69s,-0d00m40.1s,19,2,17,343,1853,1080
SN2005A,2005-01-05,2h30m43.25s,-2d56m19.8s,4,2,2,46,304,304
SN2005G,2005-01-14,13h44m32.79s,4d46m44.3s,5,2,3,273,2281,843
SN2005S,2005-01-22,14h08m28.84s,7d03m27.2s,6,3,3,255,1179,98
SN2005ac,2005-02-04,13h39m55.953s,0d52m17.17s,5,2,3,294,2260,792
SN2005ai,2005-02-12,7h10m32.76s,75d21m29.1s,5,3,2,129,18,19
SN2005ca,2005-05-12,13h32m38.55s,11d48m33.7s,2,1,1,6,713,714
SN2005cc,2005-05-19,13h57m04.85s,41d50m41.8s,3,1,2,347,2119,2119
SN2005co,2005-06-20,23h30m53.58s,-2d56m18.4s,12,4,8,250,1172,468
SN2005cr,2005-06-24,12h22m17.21s,12d23m49.3s,6,2,4,450,688,688
SN2005dh,2005-08-10,15h54m03.32s,23d08m09.9s,5,3,2,53,651,338
SN2005ed,2005-09-09,0h02m49.36s,0d45m04.8s,16,2,14,689,789,752
SN2005ef,2005-09-09,0h58m22.87s,0d40m44.6s,12,2,10,703,780,746
SN2005eg,2005-09-09,1h02m08.49s,-0d52m44.5s,10,2,8,703,779,758
SN2005eh,2005-09-09,21h49m44.4s,0d39m27.248s,6,4,2,740,1102,1103
SN2005ej,2005-09-23,18h53m38.48s,66d13m59.3s,7,3,4,406,657,657
SN2005eq,2005-09-30,3h08m49.31s,-7d01m59.7s,8,4,4,674,825,745
SN2005eu,2005-10-04,2h27m43.3s,28d10m37.8s,21,6,15,676,2238,38
SN2005ev,2005-10-06,2h31m04.93s,27d42m06.5s,4,2,2,678,1110,1110
SN2005ex,2005-09-03,1h41m51.28s,-0d52m36.3s,12,6,6,688,1139,752
SN2005fb,2005-09-10,3h01m17.544s,-0d38m38.63s,10,2,8,652,1195,1168
SN2005fd,2005-09-10,21h35m11.76s,0d09m47.3s,291,105,186,43,1833,0
SN2005fe,2005-09-10,22h19m27.32s,0d29m39.9s,245,110,135,740,1823,365
SN2005ff,2005-09-10,22h30m41.04s,-0d46m34.47s,2,1,1,381,2223,2224
SN2005fh,2005-09-10,23h17m29.736s,0d25m47.3s,12,4,8,746,1125,388
SN2005fi,2005-09-11,0h07m58.69s,0d38m17.4s,20,2,18,691,1119,369
SN2005fn,2005-09-13,20h48m53.05s,0d11m28s,10,6,4,757,1085,328
SN2005fq,2005-09-14,0h53m44.05s,-0d33m36.8s,9,2,7,710,1501,740
SN2005fr,2005-09-14,1h08m22.02s,-0d05m46.7s,10,2,8,708,1882,753
SN2005ft,2005-09-14,2h42m04.98s,-0d32m27s,2,1,1,687,2260,2261
SN2005fv,2005-09-15,3h05m22.42s,0d51m30.1s,14,2,12,657,1185,765
SN2005fx,2005-09-15,22h56m48.34s,0d24m03.9s,26,8,18,399,1482,1071
SN2005fy,2005-09-16,3h20m21.7s,-0d53m08.1s,10,2,8,661,1185,765
SN2005fz,2005-09-21,21h03m41.22s,0d34m10.3s,23,7,16,758,1402,320
SN2005gc,2005-09-22,1h21m37.584s,-0d58m38.01s,12,4,8,361,1133,743
SN2005gd,2005-09-22,1h47m51.048s,0d38m25.8s,6,4,2,353,1123,1123
SN2005ge,2005-09-22,2h18m14.73s,0d47m47.6s,12,2,10,668,1153,1128
SN2005gf,2005-09-22,22h16m16.61s,0d42m29.5s,217,114,103,752,2157,353
SN2005gg,2005-09-22,22h18m41.16s,0d38m21.1s,220,114,106,752,2211,353
SN2005gh,2005-09-23,20h50m36.35s,-0d21m14.8s,7,6,1,760,1392,1392
SN2005gj,2005-10-01,3h01m11.96s,-0d33m13.9s,10,2,8,673,1174,1147
SN2005go,2005-09-14,1h10m49.18s,1d00m28.4s,7,4,3,708,1839,740
SN2005gq,2005-09-22,3h33m48.97s,0d42m33.7s,6,2,4,665,1167,825
SN2005gr,2005-09-22,3h36m37.49s,1d04m45s,4,2,2,665,1168,1168
SN2005gu,2005-09-26,0h48m57.05s,-0d54m20.8s,6,2,4,722,741,728
SN2005gw,2005-09-26,23h37m59.6s,0d38m31.7s,8,4,4,713,724,364
SN2005gx,2005-09-26,23h59m32.16s,0d44m12.91s,12,2,10,706,774,392
SN2005gy,2005-09-28,1h26m06.79s,0d40m36.8s,8,4,4,367,1094,735
SN2005hc,2005-10-12,1h56m47.976s,-0d12m48.62s,14,4,10,372,1884,1105
SN2005hj,2005-10-26,1h26m48.4s,-1d14m17.2s,13,6,7,733,1459,732
SN2005hk,2005-10-30,0h27m50.89s,-1d11m53.3s,14,4,10,756,742,706
SN2005ho,2005-09-26,0h59m24.096s,0d00m09.44s,6,2,4,720,741,741
SN2005hr,2005-10-03,3h18m33.816s,0d07m24.03s,11,2,9,678,1168,789
SN2005ht,2005-10-11,20h50m24.6s,-0d10m04.4s,10,6,4,785,1057,300
SN2005hu,2005-10-11,21h54m40.8s,0d24m47.8s,7,1,6,17,1058,315
SN2005hv,2005-10-11,22h12m43.92s,-0d02m06.14s,99,11,88,430,1791,1044
SN2005hz,2005-10-11,0h46m32.27s,0d50m17.4s,10,2,8,737,1066,725
SN2005ia,2005-10-11,1h11m35.02s,-0d00m21s,15,2,13,735,1854,722
SN2005ib,2005-10-11,1h31m25.7s,-0d36m12.3s,10,4,6,380,1103,359
SN2005id,2005-10-12,23h16m33.36s,-0d39m48.13s,25,4,21,779,1474,350
SN2005ie,2005-10-12,2h19m02.53s,-0d16m22s,4,2,2,688,1108,1109
SN2005ig,2005-10-20,22h30m31.47s,-0d30m09.5s,2,1,1,421,2183,2184
SN2005ih,2005-10-20,0h07m13.58s,0d20m56.3s,14,2,12,730,748,712
SN2005ij,2005-10-21,3h04m21.264s,-1d03m46.87s,8,2,6,693,1109,730
SN2005il,2005-09-03,1h53m06.77s,1d06m49.5s,34,4,30,333,1923,773
SN2005in,2005-09-26,2h13m28.18s,-0d58m05.7s,8,6,2,711,1122,1122
SN2005is,2005-10-12,0h21m44.9s,-0d19m30s,20,2,18,385,1083,338
SN2005ix,2005-10-21,20h41m55.88s,1d05m31.3s,14,4,10,466,1717,286
SN2005ja,2005-10-21,23h55m52.64s,0d52m37.1s,8,2,6,731,699,366
SN2005jc,2005-10-23,0h45m24.41s,1d04m32.1s,6,2,4,749,1054,1055
SN2005jf,2005-10-24,3h33m40.76s,-0d06m43.6s,6,2,4,697,1138,412
SN2005jh,2005-10-25,23h20m04.47s,-0d03m20.2s,10,4,6,791,1081,343
SN2005jj,2005-10-28,20h56m44.66s,0d24m30s,10,7,3,795,1358,1041
SN2005jk,2005-10-20,1h45m59.736s,1d11m44.63s,10,4,6,381,1095,717
SN2005jn,2005-10-26,0h19m00.84s,-0d16m53.3s,18,2,16,399,1069,324
SN2005jo,2005-10-26,3h28m21.68s,-0d19m34.1s,8,2,6,701,1146,791
SN2005jp,2005-10-28,2h09m50.38s,-0d03m42.2s,8,4,4,388,1090,1090
SN2005jr,2005-10-30,1h00m12.37s,0d20m26.9s,6,2,4,754,741,707
SN2005js,2005-10-20,1h34m41.51s,-0d36m19.4s,10,4,6,381,1094,716
SN2005jw,2005-10-25,20h40m19.25s,-0d00m25.9s,14,4,10,470,1713,282
SN2005jy,2005-10-20,23h13m51.6s,1d15m25.2s,6,2,4,727,1085,1059
SN2005jz,2005-10-11,1h31m27.07s,-0d37m54s,10,4,6,380,1103,359
SN2005ka,2005-10-20,22h13m55.96s,1d05m11.4s,56,6,50,438,2122,1035
SN2005kc,2005-11-09,22h34m07.34s,5d34m06.3s,3,2,1,454,2157,2158
SN2005ke,2005-11-13,3h35m04.35s,-24d56m38.8s,6,2,4,360,771,699
SN2005ko,2005-10-28,23h50m05.03s,-0d55m17.1s,10,6,4,796,721,677
SN2005kq,2005-11-02,23h11m20.91s,-0d36m31s,12,10,2,800,1073,1073
SN2005kt,2005-11-07,1h10m58.06s,0d16m34.3s,11,2,9,762,1827,700
SN2005ky,2005-11-29,2h24m36.254s,-4d10m54.94s,220,112,108,720,1809,323
SN2005le,2005-11-02,22h31m32.29s,-0d29m36.8s,2,1,1,434,2170,2171
SN2005lh,2005-11-04,21h55m48.33s,1d10m51s,17,5,12,454,1021,287
SN2005lj,2005-11-07,1h57m43.16s,-0d10m46.2s,8,4,4,398,1078,1079
SN2005ln,2005-11-20,0h27m00.12s,-0d35m11.8s,10,4,6,777,672,672
SN2005lo,2005-11-24,0h37m11.87s,-1d12m12.4s,10,2,8,768,703,681
SN2005lp,2005-11-24,1h47m42.8s,0d12m25.9s,6,4,2,416,1060,1060
SN2005mc,2005-12-23,8h27m06.36s,21d38m45.6s,8,6,2,340,791,792
SN2005ml,2005-11-14,2h14m04.41s,-0d14m21s,6,2,4,721,1074,1075
SN2005mn,2005-11-23,3h49m18.44s,-0d41m31.5s,12,2,10,382,2192,384
SN2005mo,2005-11-23,3h50m12.9s,-0d14m24.9s,14,2,12,723,1822,1119
SN2005mp,2005-11-24,1h04m45.67s,0d03m20.3s,8,2,6,779,703,682
SN2005mq,2005-11-27,23h20m21.78s,-0d20m59.6s,6,4,2,824,1048,1048
SN2005mr,2005-12-13,12h36m32.253s,62d15m14.48s,211,133,78,684,1912,72
SN2006D,2006-01-11,12h52m33.87s,-9d46m30.7s,4,1,3,254,840,103
SN2006E,2006-01-12,13h53m28.65s,5d12m22.8s,6,2,4,636,1919,834
SN2006P,2006-01-23,3h19m17.9s,-12d06m18.3s,6,2,4,785,318,319
SN2006X,2006-02-04,12h22m53.93s,15d48m32s,9,1,8,663,1526,35
SN2006Z,2006-02-01,13h44m58.07s,26d18m25.7s,4,3,1,326,464,465
SN2006af,2006-02-04,10h33m57.17s,20d20m25.7s,3,1,2,324,387,58
SN2006ap,2006-03-02,17h30m41.19s,6d16m33.1s,8,4,4,578,448,448
SN2006ax,2006-03-20,11h24m03.46s,-12d17m29.2s,2,1,1,341,364,365
SN2006ay,2006-02-24,15h59m12.76s,20d44m27.9s,5,3,2,278,413,142
SN2006bk,2006-04-03,15h04m32.703s,35d57m54.03s,7,3,4,671,390,370
SN2006bm,2006-04-05,11h18m21.41s,28d12m43.5s,7,3,4,399,367,321
SN2006br,2006-04-25,13h30m01.8s,13d24m56.8s,5,1,4,354,1857,376
SN2006bt,2006-04-26,15h56m33.81s,20d03m07.2s,3,2,1,339,352,353
SN2006bu,2006-04-27,13h52m47.81s,5d18m49.4s,6,2,4,741,1814,729
SN2006bz,2006-05-04,13h00m43.38s,27d57m41.8s,88,2,86,57,1459,335
SN2006cc,2006-05-06,16h09m56.44s,43d07m35s,8,6,2,721,1110,1111
SN2006cg,2006-05-06,13h05m02.32s,28d44m24s,4,2,2,59,333,333
SN2006ch,2006-05-09,23h47m06.12s,29d28m50.6s,4,3,1,583,1979,1980
SN2006cz,2006-06-14,14h48m36.66s,-4d44m30.7s,2,1,1,393,334,335
SN2006dd,2006-06-19,3h22m41.64s,-37d12m13.2s,6,2,4,925,555,480
SN2006dm,2006-07-03,23h41m47.84s,-3d40m08.4s,6,4,2,1001,791,791
SN2006eb,2006-07-22,1h13m41.1s,-0d06m06.4s,14,2,12,1019,1889,438
SN2006ef,2006-08-18,2h04m19.51s,-8d43m42.2s,9,6,3,1038,1154,441
SN2006en,2006-08-26,23h10m05.06s,30d13m24s,4,2,2,22,65,65
SN2006eq,2006-08-26,21h28m37.13s,1d13m41.2s,14,4,10,8,742,21
SN2006er,2006-08-26,0h21m37.895s,-1d00m38.23s,6,4,2,1082,430,431
SN2006eu,2006-09-03,20h02m51.15s,49d19m02.3s,4,2,2,45,8,9
SN2006ex,2006-08-27,20h38m43.92s,-0d28m34.98s,31,23,8,776,1407,13
SN2006fb,2006-08-27,23h35m51.51s,-0d10m37.6s,8,4,4,1048,388,27
SN2006fc,2006-09-11,21h34m46.8s,1d10m31.51s,18,14,4,1107,307,307
SN2006fd,2006-08-27,20h37m53.25s,1d13m16.1s,4,2,2,24,13,13
SN2006fe,2006-08-27,20h52m09.1s,-0d30m39.3s,7,6,1,1098,1054,1054
SN2006ff,2006-08-28,0h26m35.64s,-0d18m07.5s,8,4,4,1058,428,428
SN2006fk,2006-09-11,22h01m01.33s,0d42m58.5s,12,8,4,765,1096,741
SN2006fl,2006-09-11,22h11m27.6s,0d45m20.16s,62,9,53,765,1441,13
SN2006fm,2006-09-15,22h10m10.32s,0d30m14.12s,57,9,48,769,1437,9
SN2006fn,2006-09-15,23h00m05.98s,0d32m15.6s,12,8,4,764,755,13
SN2006fr,2006-08-27,20h50m30.21s,0d23m55.3s,10,7,3,1105,737,7
SN2006fu,2006-08-28,23h51m08.4s,-0d44m47.64s,8,2,6,1044,441,32
SN2006fv,2006-09-11,1h21m37.86s,0d24m51.9s,16,2,14,715,414,78
SN2006fw,2006-09-11,1h47m10.32s,-0d08m48.8s,6,4,2,707,769,769
SN2006ga,2006-09-12,0h52m56.35s,0d26m52.6s,8,2,6,1073,383,377
SN2006ge,2006-08-28,21h49m35.79s,0d00m03.8s,6,4,2,1105,751,751
SN2006gf,2006-09-11,0h46m24.35s,0d00m12.5s,8,2,6,1072,385,378
SN2006gg,2006-09-12,0h28m12.514s,0d07m04.77s,8,2,6,720,746,389
SN2006gh,2006-09-12,0h54m46.94s,-0d15m03.7s,8,2,6,1073,424,377
SN2006gl,2006-08-28,1h05m50.11s,0d08m41.3s,8,2,6,1056,426,405
SN2006go,2006-09-12,0h24m33.76s,-0d16m44.7s,10,4,6,1073,413,389
SN2006gt,2006-09-18,0h56m17.3s,-1d37m46s,10,2,8,1079,743,733
SN2006gv,2006-09-11,1h48m36.37s,0d19m41.6s,6,4,2,707,769,769
SN2006gw,2006-09-11,1h57m53.5s,-0d32m02.9s,8,4,4,706,770,771
SN2006hb,2006-09-27,5h02m01.28s,-21d07m55.1s,8,6,2,291,112,112
SN2006hc,2006-09-11,1h09m34.73s,0d42m14.9s,14,2,12,1070,1478,378
SN2006hd,2006-09-11,21h44m03.36s,0d43m31.8s,6,4,2,1107,728,728
SN2006he,2006-09-11,22h04m24s,0d41m26.8s,13,7,6,765,710,13
SN2006hi,2006-09-17,1h23m45.96s,0d48m58.5s,8,4,4,721,740,381
SN2006hl,2006-09-18,23h22m46.08s,0d31m56.34s,13,6,7,1119,1124,15
SN2006hn,2006-09-28,11h07m18.67s,76d41m49.8s,3,2,1,1029,1875,1875
SN2006hp,2006-09-16,0h24m14.25s,-0d14m57.3s,10,4,6,1077,409,385
SN2006hq,2006-09-16,23h39m47.15s,0d12m18.8s,10,2,8,1,370,11
SN2006hr,2006-09-17,1h50m15.528s,-0d53m12.09s,8,4,4,713,763,764
SN2006ht,2006-09-20,21h12m48.189s,0d55m04.36s,17,3,14,767,1790,716
SN2006hu,2006-09-18,3h34m22.728s,-1d07m23.3s,10,2,8,1026,793,83
SN2006hy,2006-09-15,22h08m19.44s,-1d11m46.8s,14,12,2,769,707,708
SN2006ib,2006-09-22,3h16m11.83s,-0d36m03.4s,9,2,7,1032,814,434
SN2006iy,2006-09-20,22h01m53.04s,1d02m40.16s,17,6,11,773,1087,4
SN2006iz,2006-09-30,21h16m17.2s,0d33m34.2s,8,6,2,777,716,717
SN2006jg,2006-09-17,22h48m26.64s,-0d26m07s,11,8,3,768,1115,21
SN2006jh,2006-09-19,0h06m45.742s,-0d02m12.29s,14,2,12,1064,414,378
SN2006jj,2006-09-27,20h59m34.81s,1d13m23.7s,12,4,8,51,709,299
SN2006jm,2006-09-29,22h54m12.24s,1d03m03.2s,9,2,7,16,1096,9
SN2006jr,2006-10-01,3h39m47.16s,0d59m31.68s,4,2,2,1039,794,794
SN2006js,2006-10-01,20h55m20.06s,-0d05m34s,9,7,2,1133,1019,703
SN2006jt,2006-10-02,21h58m48.24s,0d11m54.65s,22,14,8,786,719,661
SN2006ju,2006-10-02,23h24m38.93s,-0d43m04.4s,24,6,18,1134,1120,693
SN2006jv,2006-10-03,1h30m32.21s,0d13m11.2s,8,4,4,737,744,368
SN2006jw,2006-10-03,2h23m22.22s,0d49m08.5s,6,2,4,1044,752,752
SN2006jx,2006-10-03,3h52m14.06s,0d17m31.5s,7,2,5,1037,1152,805
SN2006jy,2006-10-04,1h02m56.35s,0d10m58.9s,6,2,4,1093,380,381
SN2006jz,2006-10-11,0h11m24.567s,0d42m07.01s,26,4,22,1086,720,17
SN2006ka,2006-10-11,2h18m26.597s,0d13m33.72s,6,2,4,1052,744,744
SN2006kd,2006-10-13,1h07m49.944s,0d49m42.89s,20,4,16,1102,1446,346
SN2006kj,2006-09-27,3h24m32.9s,1d01m21.4s,6,2,4,1037,809,809
SN2006kk,2006-09-28,0h27m39.86s,0d38m58.2s,12,2,10,736,730,373
SN2006km,2006-09-29,2h20m37.93s,0d20m54.2s,4,2,2,1040,756,756
SN2006ko,2006-10-01,1h28m59.95s,0d46m11.8s,6,4,2,735,366,367
SN2006kp,2006-10-01,2h11m11.593s,0d41m47.79s,8,2,6,1042,779,753
SN2006kq,2006-10-02,21h15m36.49s,-0d19m18.2s,15,4,11,16,1075,708
SN2006kr,2006-10-11,0h19m19.68s,1d05m26.6s,8,2,6,25,375,17
SN2006ku,2006-10-13,23h38m13.59s,1d14m57s,10,6,4,1095,343,343
SN2006kx,2006-10-16,3h42m14.66s,0d28m42.1s,11,2,9,1050,1139,55
SN2006la,2006-10-17,22h42m48.24s,-0d54m06.33s,13,11,2,797,701,702
SN2006lb,2006-10-20,3h19m28.176s,-0d19m04.77s,10,2,8,1060,786,366
SN2006lj,2006-09-27,0h10m43.59s,0d12m06.5s,20,2,18,1072,756,373
SN2006ll,2006-10-11,22h07m28.14s,-0d54m12.3s,22,14,8,795,1082,682
SN2006ln,2006-10-11,23h15m19.91s,-0d33m45.3s,10,4,6,1143,1080,729
SN2006lo,2006-10-12,21h34m19.2s,0d35m19.6s,506,182,324,440,1436,276
SN2006lp,2006-10-13,0h27m05.68s,-0d07m33.5s,16,4,12,1104,715,345
SN2006lq,2006-10-13,2h16m35.93s,-0d09m19s,6,2,4,1054,742,742
SN2006lw,2006-09-16,2h08m33.669s,-3d57m12.9s,15,2,13,1029,1543,64
SN2006ly,2006-09-16,2h34m42.381s,-8d30m39.89s,9,4,5,694,1546,1498
SN2006md,2006-10-15,1h11m31.49s,0d24m34.3s,15,2,13,1104,1804,358
SN2006mi,2006-10-19,2h05m55.04s,-4d00m53.24s,15,2,13,1062,1513,31
SN2006mj,2006-10-19,2h09m03.038s,-3d28m27.77s,13,2,11,1062,1510,31
SN2006ml,2006-10-21,1h08m43.98s,-0d31m36.62s,10,2,8,1110,1480,351
SN2006mm,2006-10-21,1h08m48.661s,0d17m22.36s,5,1,4,1110,1438,1437
SN2006mn,2006-10-23,1h07m48.391s,-0d06m35.48s,10,2,8,1112,1478,349
SN2006mt,2006-10-16,0h59m31.06s,-0d15m24.2s,14,2,12,1105,377,356
SN2006mw,2006-10-21,3h25m08.47s,-0d02m26.1s,6,2,4,1061,786,786
SN2006na,2006-10-21,2h11m19.27s,-0d59m53.2s,8,4,4,746,732,732
SN2006nb,2006-10-22,2h26m53.376s,-0d19m40.24s,69,57,12,729,723,361
SN2006nc,2006-10-27,0h55m22.512s,-0d23m21.16s,15,2,13,1118,1093,332
SN2006nd,2006-10-28,22h44m58.812s,-1d00m23.05s,6,4,2,809,1744,1744
SN2006nf,2006-10-17,0h01m30.18s,0d16m31.7s,8,2,6,1092,350,349
SN2006ng,2006-10-21,0h22m07.27s,-0d05m44.3s,61,56,5,1142,1094,349
SN2006ni,2006-10-21,20h54m52.515s,-0d11m44.88s,9,7,2,1153,999,683
SN2006nj,2006-10-22,1h24m28.23s,0d04m27.8s,6,4,2,756,347,348
SN2006nk,2006-10-27,2h56m16.61s,-0d24m38.8s,8,6,2,706,356,357
SN2006nl,2006-10-28,2h01m44.71s,-1d01m56.7s,8,4,4,753,724,725
SN2006nn,2006-10-29,1h45m41.112s,-1d03m16.45s,6,4,2,755,721,722
SN2006no,2006-10-29,22h08m21.44s,-1d08m55.7s,14,12,2,813,663,664
SN2006np,2006-11-10,3h06m39.576s,0d03m43.15s,17,2,15,1078,1118,344
SN2006nu,2006-10-21,22h43m19s,0d15m46.5s,15,4,11,38,1751,710
SN2006nv,2006-10-28,0h12m29.86s,-0d58m38.2s,8,2,6,42,725,0
SN2006nz,2006-11-08,0h56m29.21s,-1d13m36.1s,30,8,22,1130,1081,328
SN2006oc,2006-10-17,23h02m48.35s,-0d52m35.1s,15,11,4,1112,722,326
SN2006od,2006-10-23,2h07m54.31s,-0d32m07.2s,6,4,2,748,730,730
SN2006oe,2006-10-28,23h21m26.88s,1d07m57.6s,11,2,9,25,1068,316
SN2006of,2006-10-29,0h32m25.838s,-1d03m14.04s,10,2,8,2,684,314
SN2006oi,2006-10-31,0h35m53.05s,0d15m30.3s,12,4,8,1126,327,309
SN2006oj,2006-10-31,1h08m49.2s,-0d59m22.1s,8,4,4,1120,375,341
SN2006ok,2006-11-01,1h07m28.34s,-0d16m09.7s,10,2,8,1121,1469,340
SN2006ol,2006-11-01,23h28m07.2s,0d51m22.9s,27,20,7,1163,1089,663
SN2006om,2006-11-08,1h22m18.84s,1d00m37.26s,14,4,10,773,695,329
SN2006oy,2006-10-12,20h53m58.3s,-0d21m36.2s,7,6,1,1144,1008,1008
SN2006pa,2006-10-22,2h32m24.1s,-0d42m50.7s,12,4,8,1090,745,730
SN2006pb,2006-10-23,0h46m43.55s,-1d01m57s,6,2,4,1114,349,336
SN2006pd,2006-11-08,23h31m46.08s,-0d40m05.1s,17,6,11,37,1081,656
SN2006pe,2006-11-09,0h23m09.21s,-0d03m12.9s,57,54,3,1161,1075,331
SN2006pg,2006-11-09,3h27m20.71s,1d05m22.8s,7,2,5,1080,1114,414
SN2006pi,2006-11-09,22h03m16.6s,-0d36m24.6s,11,4,7,57,1052,677
SN2006pj,2006-11-09,22h37m18.35s,0d44m17.3s,5,2,3,806,1798,673
SN2006pk,2006-11-09,23h04m59.85s,-0d52m24.1s,15,11,4,1135,699,303
SN2006pl,2006-11-11,21h54m26.88s,0d35m18.6s,19,13,6,826,662,259
SN2006pm,2006-11-11,21h54m50.621s,0d55m59.01s,23,15,8,826,662,259
SN2006pn,2006-11-13,3h49m02.85s,-0d31m58s,18,4,14,1078,1837,29
SN2006pp,2006-11-14,0h48m58.47s,0d28m37s,8,2,6,1136,354,326
SN2006pq,2006-11-14,1h25m06.888s,-1d13m09.8s,14,6,8,1117,703,325
SN2006pr,2006-11-14,1h34m14.784s,-0d24m13.23s,8,4,4,771,702,326
SN2006ps,2006-11-14,1h43m45.312s,-1d06m42.62s,8,6,2,1125,697,698
SN2006pt,2006-11-14,2h27m16.1s,-0d23m35.2s,69,57,12,752,700,338
SN2006pw,2006-11-14,22h46m26.96s,1d09m02.9s,10,8,2,826,693,694
SN2006px,2006-11-14,23h33m17.1s,0d57m40s,16,14,2,1127,310,311
SN2006py,2006-11-15,22h41m42.04s,-0d08m13.5s,10,4,6,63,1726,685
SN2006qa,2006-11-16,3h01m09.73s,-0d01m34.5s,8,2,6,1084,762,736
SN2006qb,2006-11-16,3h28m14.65s,-0d12m03.5s,6,2,4,1087,760,760
SN2006qd,2006-11-16,23h08m05.14s,-0d10m33.9s,11,9,2,1178,694,694
SN2006qg,2006-11-18,21h54m18.09s,0d26m49.2s,19,13,6,833,655,252
SN2006qh,2006-11-19,21h47m53.02s,0d42m24.6s,6,4,2,1176,666,667
SN2006rd,2006-10-26,23h19m14.02s,4d59m40s,3,2,1,804,315,315
SN2006ro,2006-11-09,3h51m16.85s,26d50m05.4s,4,2,2,321,34,35
SN2006rz,2006-11-26,3h46m06.78s,0d23m23.1s,4,2,2,1091,741,742
SN2006sb,2006-11-12,2h06m30.31s,-4d05m30.6s,19,2,17,1086,1489,7
SN2006sd,2006-11-14,1h14m24.155s,1d02m39.45s,23,4,19,778,1414,312
SN2006sf,2006-11-14,2h08m11.654s,-3d51m40.19s,21,2,19,1088,1487,5
SN2006sg,2006-11-14,2h08m13.041s,-3d46m21.93s,21,2,19,1088,1487,5
SN2006sh,2006-11-14,2h09m11.064s,-3d44m42.01s,14,2,12,1088,1484,5
SN2006si,2006-11-14,2h09m51.327s,-3d43m32.48s,14,2,12,1088,1484,5
SN2006sj,2006-11-14,2h10m22.418s,-3d33m09.32s,13,2,11,1088,1484,5
SN2006sk,2006-11-14,2h10m33.801s,-4d04m03.86s,18,2,16,1088,1484,5
SN2006sm,2006-11-14,2h33m29.487s,-8d30m11.94s,13,4,9,753,1487,1438
SN2006so,2006-11-18,2h33m49.155s,-8d59m15.78s,16,8,8,757,1462,335
SN2006sp,2006-11-24,1h10m55.17s,-0d27m52.32s,12,2,10,1144,1446,313
SN2006sr,2006-12-12,0h03m35.02s,23d11m46.2s,15,13,2,1155,268,269
SN2006su,2006-12-18,12h46m56.88s,36d32m01.8s,7,5,2,291,71,72
SN2006sw,2006-11-14,1h05m00.2s,-0d22m28.7s,12,2,10,1134,348,327
SN2006sx,2006-11-16,0h31m48.32s,-0d30m50.2s,8,2,6,15,347,293
SN2006sy,2006-11-16,2h21m05.2s,0d49m42.2s,12,2,10,1088,733,708
SN2006sz,2006-11-16,23h42m52.46s,-0d33m22.9s,10,6,4,62,652,310
SN2006ta,2006-11-19,3h29m50.42s,0d17m42.3s,11,2,9,1090,1104,402
SN2006tb,2006-11-19,3h45m15.49s,-0d07m42.8s,4,2,2,1084,748,749
SN2006tj,2006-12-13,1h09m23.282s,0d42m42.26s,16,4,12,1163,1385,285
SN2006tk,2006-12-15,1h07m52.642s,0d27m55.3s,12,2,10,1165,1383,317
SN2006tl,2006-12-15,1h09m17.279s,-0d40m27.97s,10,2,8,1165,1425,296
SN2006tm,2006-12-15,1h09m17.296s,0d09m11.31s,14,2,12,1165,1425,297
SN2006tn,2006-12-17,2h05m36.025s,-5d08m46.28s,65,2,63,800,1430,1031
SN2006to,2006-12-17,2h07m34.386s,-4d00m04.22s,17,1,16,1121,1454,1031
SN2006tp,2006-12-17,2h09m14.042s,-4d37m12.18s,31,1,30,1121,1430,1031
SN2006tr,2006-12-17,2h28m29.535s,-7d53m28.51s,12,2,10,27,1455,665
SN2006ts,2006-12-19,2h10m18.686s,-3d32m26.32s,13,4,9,1123,1449,318
SN2006tu,2006-12-19,2h29m56.537s,-7d59m50.79s,13,2,11,29,1453,663
SN2006tv,2006-12-19,2h35m34.225s,-8d34m22.03s,9,4,5,788,1452,1404
SN2006tw,2006-12-21,1h08m54.227s,0d17m56.5s,10,2,8,1171,1377,291
SN2006tx,2006-12-21,1h10m26.783s,-0d34m07.49s,12,2,10,1171,1419,290
SN2006ty,2006-12-21,1h10m45.362s,0d34m04.46s,11,2,9,1171,1418,291
SN2006ua,2006-12-16,2h25m57.01s,-8d45m38.36s,12,6,6,785,1780,307
SN2006ub,2006-12-16,2h26m21.34s,-8d54m19.82s,12,6,6,785,1780,307
SN2007N,2007-01-21,12h49m01.25s,-9d27m10.2s,3,2,1,629,67,67
SN2007R,2007-01-26,7h46m37.53s,44d47m22.1s,5,2,3,32,1078,19
SN2007S,2007-01-29,10h00m31.26s,4d24m26.2s,5,4,1,687,1139,1139
SN2007ae,2007-02-19,17h01m51.95s,79d01m54.6s,4,3,1,716,1726,1726
SN2007al,2007-03-10,9h59m18.48s,-19d28m25.8s,10,8,2,406,326,326
SN2007ar,2007-03-12,13h21m01.93s,58d33m02.4s,7,3,4,737,379,344
SN2007au,2007-03-18,7h11m46.11s,49d51m13.4s,6,4,2,85,685,685
SN2007ax,2007-03-21,8h22m43.26s,22d33m16.9s,8,6,2,793,338,339
SN2007bj,2007-04-18,16h22m10.59s,-1d30m51.4s,4,2,2,280,84,85
SN2007cj,2007-05-03,9h59m55.76s,-29d37m03.3s,4,2,2,443,270,270
SN2007cv,2007-06-29,10h37m45.4s,-27d04m57s,4,2,2,501,207,208
SN2007cz,2007-04-03,9h55m36.78s,7d18m15s,8,4,4,399,677,287
SN2007da,2007-04-04,11h05m05.66s,8d38m58.5s,9,4,5,1099,1474,364
SN2007dd,2007-04-04,13h52m49.98s,20d29m49.5s,2,1,1,660,34,34
SN2007de,2007-04-04,14h07m39.89s,19d28m04.8s,4,1,3,694,1518,34
SN2007dh,2007-04-18,11h52m36.7s,12d20m14.4s,2,1,1,48,696,696
SN2007di,2007-04-18,16h14m25.92s,5d09m21.1s,8,6,2,699,414,415
SN2007dj,2007-04-19,11h10m19.97s,-1d20m20s,9,3,6,383,686,672
SN2007do,2007-04-27,10h36m10.18s,34d32m33.4s,2,1,1,788,1015,1015
SN2007dr,2007-04-27,16h41m56s,15d22m59.1s,6,4,2,718,80,81
SN2007ds,2007-04-29,16h14m04.6s,8d55m20s,6,2,4,288,397,73
SN2007du,2007-05-04,13h21m54.91s,23d02m26.8s,3,2,1,705,2,2
SN2007dx,2007-05-09,12h51m12.75s,-9d01m45.2s,11,7,4,737,357,358
SN2007ev,2007-06-27,22h40m06.18s,24d41m57.1s,4,2,2,278,24,24
SN2007fd,2007-06-30,14h16m19.03s,36d13m01.3s,10,8,2,762,9,10
SN2007fq,2007-07-14,20h34m55.8s,-23d06m15.8s,4,2,2,318,7,7
SN2007fr,2007-07-14,21h37m08.64s,0d26m13.553s,16,4,12,341,404,1
SN2007fs,2007-07-15,22h01m40.44s,-21d30m29.6s,6,4,2,1399,67,68
SN2007fu,2007-07-13,20h30m28.88s,-13d15m34.9s,5,4,1,1096,8,9
SN2007gi,2007-07-31,12h01m23.42s,61d53m33.8s,9,7,2,1275,244,244
SN2007gt,2007-08-16,0h16m26.1696s,-0d21m09.5688s,12,4,8,334,439,395
SN2007ht,2007-09-02,0h34m33.81s,-1d13m03.1s,10,4,6,327,18,6
SN2007hx,2007-09-03,2h06m27.288s,-0d53m57.57s,8,6,2,1418,411,411
SN2007hy,2007-09-03,3h39m42.336s,1d05m32.28s,4,2,2,1376,457,457
SN2007ia,2007-09-04,3h43m10.056s,0d06m08.8956s,12,2,10,267,817,468
SN2007ic,2007-09-05,0h05m57.9816s,1d06m11.124s,14,2,12,1415,63,26
SN2007ie,2007-09-05,22h17m36.69s,0d36m48s,219,166,53,1465,1444,5
SN2007ij,2007-09-04,23h57m22.08s,0d06m21.089s,8,4,4,1414,66,29
SN2007ik,2007-09-05,22h38m53.76s,-1d10m02.14s,11,9,2,1120,378,379
SN2007im,2007-08-31,22h26m11.78s,-12d08m09.7s,3,2,1,1474,1122,1122
SN2007ip,2007-09-10,1h35m08.82s,36d01m04.8s,6,4,2,1070,1531,1528
SN2007is,2007-09-14,16h47m14.59s,40d14m36.9s,7,4,3,109,626,273
SN2007ix,2007-09-03,0h51m30.88s,-0d56m50.6s,4,2,2,1429,47,47
SN2007iy,2007-09-03,20h41m06s,-0d25m19.6356s,35,24,11,1148,1035,323
SN2007jb,2007-09-04,0h26m33.79s,0d02m31.1s,10,2,8,1077,389,32
SN2007jc,2007-09-04,23h23m48.62s,-1d08m10.1s,6,4,2,1471,406,407
SN2007je,2007-09-12,2h11m47.31s,-0d54m44.8s,8,4,4,1072,406,406
SN2007jg,2007-09-14,3h29m50.81s,0d03m24.6s,6,2,4,277,461,103
SN2007jh,2007-09-15,3h36m01.578s,1d06m16.88s,4,2,2,1388,444,444
SN2007jj,2007-09-03,1h45m26.73s,-0d01m09.9s,10,4,6,1064,422,34
SN2007jk,2007-09-03,2h55m05.4s,-0d08m51.7s,9,6,3,1017,783,46
SN2007jo,2007-09-03,23h10m12.58s,-0d55m53.1s,12,8,4,1471,402,5
SN2007jp,2007-09-03,23h44m41.28s,-0d01m48.27s,14,8,6,353,361,19
SN2007jq,2007-09-04,0h11m58.61s,0d59m53.4s,14,4,10,353,391,29
SN2007jr,2007-09-04,2h22m57.28s,1d01m32.7s,10,2,8,1380,441,416
SN2007jt,2007-09-12,2h28m32.76s,-1d02m34.12s,6,2,4,675,397,397
SN2007ju,2007-09-14,0h11m50.465s,-0d20m21.67s,10,4,6,363,404,366
SN2007jv,2007-09-14,0h15m36.91s,-0d23m21.6s,12,4,8,363,410,366
SN2007jw,2007-09-14,2h02m32.74s,-1d05m21s,8,4,4,1074,403,404
SN2007jy,2007-09-03,20h51m21.43s,0d23m57.8s,10,9,1,1477,365,365
SN2007jz,2007-09-05,1h23m56.01s,1d15m18s,14,4,10,1074,394,28
SN2007kb,2007-09-13,20h52m24.72s,0d16m38.9s,12,11,1,1487,355,355
SN2007kd,2007-09-23,9h25m58.01s,34d37m59.3s,9,6,3,1332,903,503
SN2007kp,2007-09-13,22h09m29.59s,0d44m16.4s,57,11,46,1132,1074,342
SN2007kq,2007-09-14,0h19m43.97s,-0d24m00.35s,18,6,12,1087,381,21
SN2007kr,2007-09-14,0h25m27.59s,-0d50m21.6s,12,4,8,1440,46,22
SN2007ku,2007-09-16,1h33m28.3s,0d31m28.6s,16,4,12,1077,409,9
SN2007kv,2007-09-19,1h10m15.94s,0d28m19.2s,11,2,9,1443,1146,19
SN2007kx,2007-09-22,0h13m42.874s,0d39m08.38s,14,4,10,371,403,358
SN2007la,2007-09-30,22h29m54.72s,1d03m30.49s,2,1,1,1131,1473,1473
SN2007lc,2007-10-06,0h49m09.13s,0d35m47.8s,8,2,6,1462,28,0
SN2007le,2007-10-13,23h38m48.45s,-6d31m21.7s,10,8,2,1457,328,329
SN2007lf,2007-09-03,0h16m45.46s,1d12m03.2s,14,4,10,352,54,31
SN2007lg,2007-09-22,0h46m03.93s,-0d00m38.9s,8,2,6,1448,9,2
SN2007lh,2007-09-22,1h08m52.02s,1d11m52.4s,18,4,14,1446,1102,2
SN2007li,2007-09-22,1h13m04.02s,-0d32m24s,20,2,18,1446,1102,11
SN2007lk,2007-10-03,1h57m50.15s,-0d23m53.5s,8,4,4,1093,383,384
SN2007lm,2007-10-03,3h13m40.44s,0d37m47.9s,9,2,7,1408,446,58
SN2007ln,2007-10-03,3h40m43.21s,1d00m11s,4,2,2,1406,427,427
SN2007lo,2007-10-03,22h35m56.16s,0d36m32.79s,2,1,1,1134,1470,1470
SN2007lp,2007-10-03,22h43m41.04s,0d25m13.84s,9,4,5,385,727,364
SN2007lq,2007-10-06,0h23m07.89s,0d58m58.9s,12,2,10,1109,357,0
SN2007lt,2007-10-06,21h53m47.28s,0d00m54.1s,12,8,4,409,334,319
SN2007lu,2007-10-06,22h01m34.9s,-0d15m24.8s,11,4,7,388,721,346
SN2007lv,2007-10-06,23h24m48s,0d56m40.38s,18,6,12,1502,750,324
SN2007ly,2007-10-08,0h22m53.37s,0d46m33.5s,28,27,1,1494,742,742
SN2007ma,2007-10-08,0h44m53.77s,-0d59m48.9s,10,6,4,29,13,12
SN2007mc,2007-10-08,1h07m25.7s,1d02m37.4s,21,6,15,1462,1086,20
SN2007me,2007-10-08,1h41m03.84s,-0d26m53.78s,6,4,2,13,374,375
SN2007mf,2007-10-08,1h58m54.86s,-1d01m37.1s,8,4,4,1098,379,379
SN2007mh,2007-10-08,3h14m32.088s,0d16m08.27s,9,2,7,1413,441,53
SN2007mi,2007-10-08,3h23m31.365s,0d40m02.22s,6,2,4,1413,433,433
SN2007mk,2007-10-08,23h56m16.8s,-0d30m02.9s,10,6,4,1448,32,11
SN2007mo,2007-10-09,22h11m33.85s,0d45m53.2s,64,19,45,1158,1048,316
SN2007mp,2007-10-12,21h16m35.63s,-0d46m11.6s,20,4,16,391,1398,332
SN2007mt,2007-09-19,1h45m56.59s,-0d13m03.5s,10,4,6,1080,406,18
SN2007mu,2007-09-22,0h12m18.56s,-0d04m38.3s,10,4,6,371,396,358
SN2007mv,2007-09-22,0h35m37.668s,0d22m10.29s,12,8,4,1452,1,1
SN2007mw,2007-10-03,23h03m02.64s,0d50m57.8s,7,5,2,1147,372,372
SN2007mx,2007-10-06,21h14m10.8s,-0d17m46.5s,14,4,10,385,657,309
SN2007my,2007-10-06,21h55m32.16s,-0d22m18.5s,12,8,4,409,334,319
SN2007mz,2007-10-06,22h07m51.2s,-1d04m11.8s,14,12,2,1155,321,322
SN2007na,2007-10-06,22h13m32.88s,0d52m49.804s,67,15,52,1155,1406,319
SN2007nb,2007-10-06,23h25m30.06s,0d25m24.4s,181,168,13,1502,750,324
SN2007nd,2007-10-08,0h40m18.81s,-1d02m14.5s,8,4,4,1451,20,2
SN2007ne,2007-10-08,0h54m02.21s,1d04m08s,12,2,10,16,385,348
SN2007nf,2007-10-08,1h03m26.6s,0d19m53.83s,8,4,4,1462,11,12
SN2007ng,2007-10-08,2h25m37.94s,0d42m32s,29,28,1,1414,382,382
SN2007np,2007-10-10,1h58m49.66s,-2d26m27.5s,4,2,2,325,22,23
SN2007nq,2007-10-21,0h57m33.6s,-1d23m19.5s,10,2,8,1477,345,335
SN2007nz,2007-10-08,3h25m11.352s,-0d06m22.59s,6,2,4,1413,434,434
SN2007oa,2007-10-09,22h13m51.36s,-0d55m13.0188s,61,13,48,1158,1085,317
SN2007oi,2007-10-13,0h21m17.87s,1d04m28.3s,8,6,2,392,8,8
SN2007oj,2007-10-15,23h51m37.92s,0d16m47.38s,14,10,4,395,325,326
SN2007ol,2007-10-29,1h37m23.78s,-0d18m42.1s,10,8,2,1120,353,354
SN2007om,2007-10-30,23h54m20.72s,-0d55m02.1s,12,8,4,1472,12,12
SN2007on,2007-11-05,3h38m50.9s,-35d34m30s,90,74,16,1429,757,12
SN2007oq,2007-10-06,21h42m30.75s,0d59m04.6s,6,4,2,1497,338,339
SN2007or,2007-10-09,1h42m38.34s,1d01m49.6s,7,2,5,14,1479,376
SN2007os,2007-10-11,1h57m38.59s,-0d31m18.5s,8,4,4,1101,375,376
SN2007ot,2007-10-12,0h35m36.775s,-0d13m57.36s,12,10,2,33,29,29
SN2007ox,2007-10-13,22h46m58.08s,-0d04m18.5s,6,5,1,1159,724,725
SN2007oy,2007-10-15,23h17m55.44s,1d13m25.1s,10,4,6,377,1433,334
SN2007oz,2007-10-15,23h57m16.57s,0d14m57.7s,6,4,2,1455,25,26
SN2007pb,2007-10-19,23h48m25s,-1d11m06s,10,8,2,1517,0,0
SN2007pc,2007-10-20,21h15m49.47s,0d39m05s,8,6,2,1162,331,332
SN2007pe,2007-10-21,2h21m03.96s,0d29m47.5s,4,2,2,1427,369,369
SN2007pf,2007-10-29,22h11m43.2s,0d34m45.68s,52,9,43,1178,1028,296
SN2007pi,2007-10-30,22h46m49.28s,0d45m20.9s,10,8,2,1176,343,344
SN2007pj,2007-10-31,23h49m10.7s,0d47m52.4s,18,14,4,411,311,310
SN2007pn,2007-10-12,2h16m33.9s,-0d43m20.5s,10,6,4,1457,378,368
SN2007pq,2007-10-15,22h37m13.94s,0d44m10.8s,5,2,3,1146,1458,333
SN2007pr,2007-10-20,23h06m13.03s,0d19m44.3s,11,9,2,1517,355,356
SN2007ps,2007-10-21,2h19m13.44s,-0d23m04.4s,4,2,2,1427,369,370
SN2007pt,2007-10-29,2h07m38.372s,-0d19m26.27s,12,4,8,1119,359,359
SN2007pu,2007-10-29,22h45m58.32s,-0d38m55.99s,10,7,3,1175,1378,709
SN2007pv,2007-10-30,21h59m45.36s,1d07m42.1s,5,4,1,1179,323,324
SN2007px,2007-11-02,0h22m43.96s,-0d28m46s,20,14,6,1489,332,331
SN2007py,2007-11-04,3h29m31.51s,0d31m00.6s,7,2,5,1440,754,54
SN2007pz,2007-11-04,3h30m25.176s,1d00m33.984s,12,8,4,1440,395,54
SN2007qa,2007-11-05,1h52m34.14s,1d14m39.02s,34,6,28,1126,1130,1
SN2007qd,2007-10-31,2h09m33.552s,-1d00m02.232s,10,6,4,1476,357,353
SN2007qe,2007-11-13,23h54m12.98s,27d24m33s,6,4,2,382,295,296
SN2007qf,2007-10-21,22h15m02.88s,-0d20m30.23s,93,4,89,391,1073,304
SN2007qg,2007-10-23,1h32m01.97s,-0d25m47s,8,6,2,1122,354,355
SN2007qh,2007-10-29,0h39m30.86s,1d01m27.6s,6,4,2,1094,318,318
SN2007qi,2007-10-30,23h16m28.8s,-0d05m56.1s,23,4,19,1527,726,298
SN2007qj,2007-10-31,20h49m40.08s,0d28m06.65s,10,9,1,1535,307,307
SN2007qk,2007-10-31,21h03m14.16s,0d27m26.464s,23,13,10,1528,632,284
SN2007ql,2007-10-31,21h29m43.66s,0d26m40.6s,556,321,235,1532,1052,256
SN2007qo,2007-11-01,1h43m01.58s,-0d56m42.7s,8,6,2,1477,345,346
SN2007qr,2007-11-04,2h52m29.23s,-1d08m22.2s,9,2,7,16,1448,382
SN2007qs,2007-11-04,3h11m46.03s,0d05m30.9s,17,2,15,1440,414,26
SN2007qt,2007-11-04,3h29m25.416s,-0d38m46.7484s,11,2,9,328,755,52
SN2007qu,2007-11-04,22h32m32.82s,0d51m32.7s,2,1,1,1166,1438,1438
SN2007qy,2007-11-05,1h55m15.28s,0d38m35.2s,14,4,10,1126,1127,337
SN2007qz,2007-11-05,21h00m02.77s,0d49m39.3s,20,13,7,1533,620,290
SN2007ra,2007-11-12,23h34m24s,-0d53m25.2s,31,16,15,1490,693,353
SN2007rd,2007-10-30,20h47m01.094s,-0d05m57.59s,15,7,8,1534,978,266
SN2007re,2007-10-30,21h17m35.04s,-0d31m26.28s,11,4,7,409,682,315
SN2007rf,2007-10-30,21h55m30.96s,0d48m54.3s,12,8,4,433,309,296
SN2007rg,2007-10-31,20h51m20.27s,1d01m08s,12,6,6,450,628,294
SN2007rh,2007-10-31,21h41m03.75s,0d08m32.8s,22,14,8,442,295,268
SN2007ri,2007-11-02,1h06m52.28s,1d09m14.2s,25,12,13,1131,1061,334
SN2007rj,2007-11-02,1h53m58.86s,-0d05m33.6s,18,4,14,1124,1133,353
SN2007rk,2007-11-02,3h42m17.376s,1d03m44.17s,4,2,2,1432,399,399
SN2007rl,2007-11-04,2h21m33.07s,-0d22m29.7s,8,2,6,16,355,4
SN2007rm,2007-11-04,2h21m45.096s,0d51m52.07s,10,2,8,1441,380,355
SN2007rn,2007-11-04,23h58m01.4s,-0d44m15.2s,12,10,2,376,6,7
SN2007ro,2007-11-05,1h44m28.97s,0d13m47s,6,4,2,368,342,343
SN2007rp,2007-11-05,22h13m43.68s,0d23m46.69s,10,4,6,1185,323,289
SN2007rv,2007-11-07,1h49m52.86s,-27d28m04.1s,6,4,2,366,324,325
SN2007sb,2007-10-11,0h41m23.69s,0d24m42.4s,10,6,4,32,336,17
SN2007sc,2007-11-11,2h15m11.88s,0d32m09.258s,12,4,8,18,374,348
SN2007se,2007-11-12,22h12m37.2s,0d47m49.37s,52,9,43,1192,1014,282
SN2007sf,2007-11-12,22h48m59.1s,1d12m21.9s,8,6,2,1187,331,332
SN2007sg,2007-11-12,23h19m26.09s,-0d54m05.9s,12,4,8,405,357,306
SN2007sl,2007-11-17,21h13m42.82s,-0d50m16s,23,4,19,427,1362,267
SN2007sm,2007-11-27,21h22m50.57s,0d25m17.9s,8,4,4,123,1346,269
SN2007sn,2007-11-27,22h14m04.42s,-0d12m47.5s,51,4,47,428,1036,267
SN2007sr,2007-12-18,12h01m52.8s,-18d58m21.7s,6,5,1,1394,1512,1513
SN2007ta,2007-10-04,1h13m15.811s,-0d01m31.46s,15,4,11,1458,1450,355
SN2007tb,2007-10-04,1h14m41.25s,0d46m51.8s,26,8,18,1102,1450,25
SN2007tc,2007-10-04,1h14m46.89s,0d17m06.6s,10,2,8,12,1450,25
SN2007td,2007-10-04,2h04m26.9s,-3d44m18.9s,15,4,11,1412,1163,29
SN2007tf,2007-10-06,1h09m59.35s,-0d01m06.9s,14,2,12,1460,1130,2
SN2007tl,2007-10-10,1h11m04.91s,-0d15m43.3s,15,4,11,1464,1126,22
SN2007tm,2007-10-10,2h06m04.73s,-3d32m29.3s,15,4,11,1418,1157,23
SN2007tq,2007-10-16,2h29m23.34s,-7d52m27.7s,19,2,17,330,1152,362
SN2007tr,2007-10-18,1h10m48.01s,0d13m36.7s,11,4,7,1472,1117,4
SN2007ts,2007-11-05,1h07m58.15s,0d27m48.9s,10,4,6,1490,1058,331
SN2007tt,2007-11-05,1h11m20.516s,-0d12m19.41s,16,6,10,1490,1100,323
SN2007tv,2007-11-05,2h05m13.33s,-5d01m42.5s,64,2,62,1123,1107,708
SN2007tw,2007-11-05,2h05m32.97s,-5d02m46.6s,64,2,62,1123,1107,708
SN2007tx,2007-11-05,2h28m33.31s,-8d35m25.7s,12,2,10,16,1122,2
SN2007ty,2007-11-05,2h28m34.38s,-8d23m49.5s,22,4,18,350,1131,2
SN2007tz,2007-11-05,2h30m07.15s,-8d43m09.3s,14,2,12,16,1122,2
SN2007ua,2007-11-07,1h10m31.939s,0d35m49.58s,8,3,5,1492,1097,1055
SN2007ub,2007-11-07,2h07m24.14s,-3d51m55.2s,16,2,14,353,1129,1123
SN2007uc,2007-11-07,2h10m15.53s,-4d04m06.5s,14,4,10,1446,1126,707
SN2007ud,2007-11-07,2h30m13.15s,-9d15m39.4s,13,6,7,1111,1120,1081
SN2007uf,2007-11-11,2h06m30.88s,-4d09m55s,44,1,43,1450,1125,702
SN2007ug,2007-11-11,2h09m36.85s,-4d51m52.2s,33,1,32,13,1101,702
SN2007uh,2007-11-13,2h06m05.2s,-4d01m37.5s,12,3,9,1452,1123,700
SN2007ui,2007-11-13,2h34m57.12s,-8d04m00.2s,9,4,5,1449,1123,1075
SN2007uj,2007-11-15,2h33m19.03s,-8d32m30.2s,13,4,9,1119,1121,1072
SN2007uk,2007-12-01,1h10m55s,-0d22m53.2s,12,6,6,1516,1074,297
SN2007ul,2007-12-01,2h07m16.53s,-4d42m23.2s,64,1,63,1470,1081,682
SN2007um,2007-12-03,1h12m29.21s,0d17m01.2s,8,3,5,1518,1390,1029
SN2007un,2007-12-03,1h14m22.73s,1d07m45.6s,23,10,13,1162,1030,296
SN2007uo,2007-12-03,1h15m11.99s,-0d02m08.4s,24,14,10,72,1390,296
SN2007up,2007-12-03,2h09m56.07s,-4d28m57.4s,31,1,30,35,1079,680
SN2007uq,2007-12-07,2h04m21.31s,-3d54m10.9s,12,3,9,1476,1099,676
SN2007ur,2007-12-07,2h08m41.59s,-3d34m10.5s,10,3,7,1476,1096,677
SN2007us,2007-12-07,2h27m54.87s,-8d00m55.2s,12,2,10,382,1100,310
SN2007ut,2007-12-07,2h30m23.64s,-9d12m20s,17,4,13,48,1090,309
SN2007uu,2007-12-09,1h14m01.02s,0d53m47.5s,27,14,13,1168,1024,290
SN2007uv,2007-12-12,1h14m43.18s,0d54m27.7s,24,14,10,1171,321,287
SN2007uw,2007-12-12,2h30m09.8s,-7d40m49.1s,11,2,9,387,1092,305
SN2007ux,2007-12-23,10h09m19.98s,14d59m32.8s,5,1,4,661,1138,1137
SN2008J,2008-01-15,2h34m24.2s,-10d50m38.5s,3,2,1,87,1040,1040
SN2008ab,2008-01-30,11h34m45.92s,53d57m50.8s,3,2,1,1424,726,727
SN2008ac,2008-01-30,11h53m45.18s,48d25m21.5s,3,2,1,1408,1135,1136
SN2008ae,2008-02-09,9h56m03.2s,10d29m58.8s,4,2,2,1063,1085,1086
SN2008af,2008-02-09,14h59m28.5s,16d39m12.3s,3,1,2,253,1206,1192
SN2008ah,2008-02-11,10h51m48.45s,3d46m35.7s,9,2,7,680,743,372
SN2008bg,2008-03-05,12h51m11.89s,26d17m40.2s,17,13,4,1423,51,52
SN2008bi,2008-03-22,8h35m53.39s,0d42m23.1s,5,3,2,1503,306,306
SN2008ca,2008-03-10,12h29m01.29s,12d22m18s,185,179,6,1459,413,412
SN2008cj,2008-05-10,12h31m50.71s,14d01m13.6s,3,1,2,389,691,690
SN2008cl,2008-05-16,16h11m04.35s,52d27m08s,29,28,1,1464,804,804
SN2008cr,2008-04-02,11h43m34.44s,46d22m03.6s,2,1,1,1469,1061,1061
SN2008dh,2008-06-08,0h35m11.32s,23d15m15.1s,3,2,1,1705,1246,1246
SN2008dm,2008-06-03,11h43m23.16s,46d04m58.8s,3,1,2,1531,1015,999
SN2008dr,2008-06-28,22h10m51.67s,2d06m29.6s,5,2,3,643,448,441
SN2008ds,2008-06-28,0h29m50.83s,31d23m33.9s,3,1,2,599,1231,1222
SN2008ee,2008-07-16,0h56m32.96s,-1d46m16s,10,2,8,1746,76,66
SN2008fj,2008-09-01,17h12m49.86s,42d48m51.8s,7,4,3,766,342,266
SN2008gs,2008-09-21,1h27m05.78s,3d13m05.7s,2,1,1,325,1132,1133
SN2008hd,2008-09-24,23h54m07.84s,-10d15m43.4s,31,23,8,1836,406,383
SN2008hr,2008-11-23,9h18m52.44s,18d57m20.4s,3,2,1,1006,474,475
SN2008hv,2008-12-02,9h07m34.06s,3d23m32.1s,16,8,8,1784,55,37
SN2008hz,2008-11-26,0h43m18.62s,42d10m14.2s,81,20,61,1908,1077,268
SN2008id,2008-11-03,2h27m46.8s,-4d34m47.1s,121,96,25,1833,739,19
SN2008iq,2008-12-30,10h39m26.86s,5d05m24.2s,4,2,2,1007,45,46
SN2008ir,2008-11-27,8h16m12.44s,-7d21m32.3s,10,1,9,1780,422,392
SN2008s1,2008-05-16,13h29m12.84s,11d16m20.5s,5,3,2,1106,349,350
SN2008s5,2008-09-09,22h01m49.07s,13d03m19.1s,4,2,2,729,338,303
SN2009L,2009-01-13,12h58m48.1s,27d40m25.6s,92,8,84,1714,474,83
SN2009an,2009-02-27,12h22m47.4s,65d51m04s,2,1,1,785,331,331
SN2009as,2009-03-08,14h47m26.64s,-30d39m34.5s,3,1,2,639,822,822
SN2009cb,2009-03-19,12h59m15.85s,27d16m41.3s,79,74,5,1801,375,45
SN2009cj,2009-03-21,9h45m30.44s,6d32m23.3s,7,6,1,1469,318,319
SN2009cn,2009-03-21,11h03m06.64s,50d09m36.3s,3,1,2,768,348,312
SN2009cp,2009-03-25,9h15m12.73s,19d05m46.3s,4,3,1,1524,351,352
SN2009cs,2009-03-25,14h15m19.36s,16d25m14s,3,1,2,676,780,779
SN2009cu,2009-03-26,13h29m12.64s,46d43m27.5s,22,20,2,2106,809,803
SN2009cx,2009-03-28,12h24m39.2s,8d55m59.2s,20,10,10,1823,41,31
SN2009cz,2009-04-06,9h15m00.02s,29d44m07.1s,13,3,10,1172,696,691
SN2009db,2009-03-19,14h21m54.63s,26d01m02s,11,2,9,710,86,49
SN2009dg,2009-03-03,11h33m44.93s,14d34m47.9s,4,3,1,739,11,11
SN2009dk,2009-04-01,11h30m23.64s,2d14m35.2s,4,2,2,1109,722,722
SN2009dl,2009-04-15,12h08m07.21s,-31d59m25.3s,3,1,2,738,1022,753
SN2009du,2009-04-17,13h39m46.36s,-21d27m19.1s,3,2,1,1793,764,765
SN2009eh,2009-04-03,15h20m38.08s,7d39m32.5s,5,3,2,716,775,775
SN2009eu,2009-05-21,16h28m41.13s,39d33m12.5s,7,5,2,1831,0,1
SN2009ey,2009-05-15,14h09m16.68s,53d06m12.8s,19,4,15,10,668,37
SN2009ez,2009-05-15,13h12m54.49s,43d28m35.9s,4,2,2,1868,672,672
SN2009fc,2009-05-17,15h27m48.59s,41d35m34.1s,3,2,1,1802,23,23
SN2009fh,2009-05-20,15h44m38.77s,45d47m51.2s,3,2,1,772,801,801
SN2009fj,2009-05-27,12h06m22.97s,-44d27m34.3s,3,2,1,849,981,982
SN2009fk,2009-05-29,22h44m23.9s,-0d09m42s,6,4,2,989,800,122
SN2009fl,2009-05-30,16h25m10.1s,40d53m20.8s,5,3,2,1841,4,5
SN2009gb,2009-06-09,14h47m25.83s,-30d39m02.5s,3,1,2,732,729,729
SN2009gf,2009-06-15,14h15m37.11s,14d16m48.6s,3,2,1,1481,0,1
SN2009hn,2009-07-24,2h32m00.31s,1d14m53.5s,10,9,1,644,849,850
SN2009iv,2009-08-21,2h58m14.21s,5d58m19s,4,2,2,672,63,63
SN2009iy,2009-09-15,13h30m10.54s,80d30m26.8s,4,3,1,2114,790,790
SN2009ko,2009-10-28,8h01m58.38s,15d03m34.7s,4,2,2,1360,61,58
SN2009ks,2009-09-09,22h15m48s,1d11m05.39s,50,26,24,2187,702,1
SN2009kt,2009-09-15,2h28m28.368s,-4d04m44.08s,52,4,48,1030,426,42
SN2009ku,2009-09-22,3h29m53.232s,-28d05m12.12s,56,28,28,2143,442,42
SN2009kv,2009-09-30,2h21m06.6s,-5d01m23.84s,92,65,27,1801,408,27
SN2009kw,2009-09-30,3h38m23.4s,-28d15m11.88s,50,30,20,1388,430,37
SN2009kx,2009-09-30,2h21m13.752s,-3d54m35.82s,28,3,25,1051,408,29
SN2009ky,2009-09-30,3h34m28.8s,-27d54m30.24s,257,113,144,2151,434,34
SN2009kz,2009-09-30,2h22m40.08s,-4d01m38.32s,34,12,22,1440,408,27
SN2009me,2009-12-03,12h09m39.86s,43d40m30s,5,3,2,1737,499,469
SN2009ml,2009-10-14,23h53m33.47s,-10d09m49.9s,31,24,7,2221,21,0
SN2009ms,2009-11-18,10h39m55.4s,39d48m10.9s,3,2,1,2121,72,73
SN2009mt,2009-11-25,4h02m57.68s,17d56m26.7s,5,3,2,1462,748,392
SN2009ni,2009-12-16,8h44m41.49s,-6d19m35.3s,3,2,1,1391,26,26
SN2010ai,2010-03-08,12h59m24s,27d59m47.5s,49,38,11,1068,55,20
SN2010ar,2010-02-13,10h03m26.078s,1d01m45.91s,45,26,19,2151,368,2
SN2010bb,2010-01-16,10h44m38.225s,57d48m40.04s,25,24,1,2182,5,5
SN2010bu,2010-04-09,15h42m58.38s,2d16m52.6s,3,1,2,1068,395,394
SN2010dl,2010-05-24,21h35m00.97s,-0d30m47.8s,133,120,13,2468,116,70
SN2010ex,2010-07-01,23h00m10.81s,26d05m56.2s,3,2,1,2453,459,460
SN2010fa,2010-05-13,14h13m01.87s,54d27m46.6s,18,16,2,373,305,304
SN2010fb,2010-05-31,16h08m18.409s,54d54m29.34s,45,36,9,2209,375,17
SN2010fc,2010-05-31,16h14m28.674s,54d43m32.92s,60,45,15,2526,375,17
SN2010fd,2010-06-01,14h07m14.923s,53d59m51.4s,19,17,2,2538,286,285
SN2010fe,2010-06-01,16h08m52.639s,55d00m17.32s,45,36,9,2210,374,16
SN2010fh,2010-06-06,14h17m18.567s,53d58m41.96s,20,18,2,397,281,280
SN2010fn,2010-06-06,16h18m15.872s,55d23m04.95s,44,33,11,2215,369,12
SN2010fs,2010-06-15,14h14m03.34s,53d21m43.87s,18,16,2,406,272,271
SN2010kn,2010-12-02,11h50m17.04s,43d57m47s,9,8,1,2443,91,92
SN2011H,2011-01-04,2h23m06.02s,43d02m32.4s,7,6,1,1878,317,318
SN2011ad,2011-02-11,11h45m59.58s,46d46m50.5s,2,1,1,2514,16,16
SN2011cx,2011-05-02,12h14m22.16s,33d55m09.5s,4,3,1,2156,37,38
SN2011dp,2011-06-02,1h45m24.77s,-3d49m35.3s,2,1,1,2760,185,185
SN2011fw,2011-09-23,3h20m54.24s,37d52m05.3s,3,2,1,2142,94,95
SNF20080322-001,2008-03-22,16h14m48.956s,43d53m29.42s,5,4,1,1407,1226,1226
SNF20080322-003,2008-03-22,17h04m21.445s,36d15m29.83s,4,2,2,299,1227,1210
SNF20080522-000,2008-05-22,13h36m47.61s,5d08m32.6s,2,1,1,1497,1056,1056
SNF20080623-007,2008-06-23,23h53m42.06s,31d52m41.5s,4,2,2,604,1231,1204
SNF20080626-002,2008-06-26,22h45m02.49s,8d56m39s,3,2,1,1415,1198,1198
SNF20080707-012,2008-07-07,22h42m40.96s,22d15m20.9s,11,4,7,654,453,10
SNF20080717-000,2008-07-17,0h06m54.28s,24d59m52.5s,13,11,2,1738,437,405
SNF20080725-003,2008-07-25,0h34m51.11s,-5d54m03.1s,2,1,1,617,1190,1190
SNF20080821-000,2008-08-21,20h24m19.93s,6d10m28.3s,3,2,1,1511,1094,1094
SNF20080906-009,2008-09-06,22h10m24.9s,4d25m53.5s,4,3,1,1488,380,380
SNF20080918-000,2008-09-18,23h33m18.98s,25d12m50.8s,5,4,1,1494,1116,1116
SNF20080918-002,2008-09-18,22h41m48.12s,17d37m38.9s,5,4,1,1816,1108,1109
SNF20080919-000,2008-09-19,0h03m34.48s,24d13m04.4s,7,6,1,1802,342,343
SNF20080919-002,2008-09-19,2h25m21.21s,-8d38m59.4s,7,5,2,1428,1137,1121
SNF20080926-009,2008-09-26,22h08m22.38s,-10d58m21s,5,3,2,1857,1111,728
SNLS-03D1co,2003-11-21,2h26m16.259s,-4d56m06.18s,294,22,272,24,2548,0
SNLS-03D1dt,2003-11-28,2h26m31.192s,-4d03m08.43s,345,104,241,31,2541,12
SNLS-03D1ew,2003-12-20,2h24m14.111s,-4d39m57.07s,273,32,241,10,2519,0
SNLS-03D1fb,2003-12-18,2h27m12.875s,-4d07m16.44s,150,94,56,51,2521,1
SNLS-03D1fc,2003-12-23,2h25m43.596s,-4d08m38.61s,361,156,205,56,2516,359
SNLS-03D1fl,2003-12-20,2h25m58.298s,-4d07m44.03s,151,55,96,38,1798,0
SNLS-03D1fq,2003-12-23,2h26m55.664s,-4d18m07.98s,302,146,156,56,2516,359
SNLS-03D1gt,2004-01-19,2h24m56.01s,-4d07m36.81s,308,139,169,82,2489,332
SNLS-03D4cx,2003-09-04,22h14m33.754s,-17d35m15.04s,211,20,191,4,2209,1
SNLS-03D4cy,2003-09-25,22h13m40.415s,-17d40m53.91s,211,46,165,25,2188,299
SNLS-03D4cz,2003-09-26,22h16m41.86s,-17d55m34.57s,199,46,153,26,2187,298
SNLS-03D4di,2003-09-05,22h14m10.239s,-17d30m23.82s,211,20,191,5,2208,0
SNLS-03D4dy,2003-09-28,22h14m50.526s,-17d57m23.32s,210,46,164,28,2185,296
SNLS-03D4gf,2003-11-24,22h14m22.932s,-17d44m02.52s,211,46,165,85,2128,239
SNLS-03D4gg,2003-11-25,22h16m40.19s,-18d09m52.05s,199,46,153,86,2127,238
SNLS-03D4gl,2003-11-21,22h14m44.174s,-17d31m44.09s,211,46,165,82,2131,242
SNLS-04D1ag,2004-01-17,2h24m41.097s,-4d17m19.5s,318,146,172,81,2491,334
SNLS-04D1aj,2004-01-18,2h25m53.96s,-4d59m40.6s,340,140,200,82,2523,302
SNLS-04D1ak,2004-01-22,2h27m33.355s,-4d19m38.78s,281,135,146,86,2486,329
SNLS-04D1dc,2004-08-10,2h26m18.4s,-4d18m42.5s,128,59,69,272,1564,128
SNLS-04D1de,2004-08-17,2h26m35.909s,-4d25m21.44s,304,146,158,294,2278,121
SNLS-04D1ff,2004-09-09,2h25m38.622s,-4d54m09.47s,296,140,156,317,2255,98
SNLS-04D1hd,2004-09-20,2h26m08.834s,-4d06m34.68s,346,156,190,328,2244,87
SNLS-04D1hx,2004-09-18,2h24m42.495s,-4d47m25.17s,153,40,113,311,2246,58
SNLS-04D1hy,2004-09-11,2h24m08.694s,-4d49m51.86s,254,46,208,276,2253,65
SNLS-04D1iv,2004-09-20,2h24m48.051s,-4d09m09.21s,246,78,168,327,2244,87
SNLS-04D1jd,2004-09-20,2h27m50.836s,-4d56m37.64s,118,92,26,328,2244,790
SNLS-04D1jg,2004-09-21,2h26m12.557s,-4d08m05.28s,200,92,108,329,2243,86
SNLS-04D1kj,2004-10-09,2h27m52.66s,-4d10m48.91s,122,94,28,347,2225,771
SNLS-04D1oh,2004-10-19,2h25m02.362s,-4d14m10.27s,314,146,168,357,2215,58
SNLS-04D1ow,2004-11-12,2h26m42.696s,-4d18m22.28s,304,146,158,381,2191,34
SNLS-04D1pc,2004-11-13,2h26m24.876s,-4d23m57.84s,126,59,67,367,1469,33
SNLS-04D1pd,2004-11-11,2h27m39.752s,-4d37m52.22s,135,96,39,380,2192,348
SNLS-04D1pg,2004-11-13,2h27m04.159s,-4d10m31.03s,302,146,156,382,2190,33
SNLS-04D1pp,2004-11-12,2h25m12.478s,-4d42m05.7s,315,146,169,381,2191,34
SNLS-04D1pu,2004-12-11,2h27m28.474s,-4d44m41.76s,137,96,41,410,2162,318
SNLS-04D1qd,2004-11-17,2h26m33.075s,-4d06m25.84s,344,156,188,386,2186,29
SNLS-04D1rh,2004-12-13,2h27m47.148s,-4d15m13.56s,122,94,28,412,2160,706
SNLS-04D1rx,2004-12-12,2h25m11.03s,-4d37m06.06s,306,146,160,411,2159,4
SNLS-04D1sa,2004-12-15,2h27m56.159s,-4d10m33.85s,122,94,28,414,2158,704
SNLS-04D1si,2004-12-15,2h24m48.796s,-4d34m08.22s,348,152,196,414,2158,1
SNLS-04D2bt,2004-03-18,9h59m32.74s,2d14m52.8s,269,167,102,36,2547,2
SNLS-04D2ca,2004-03-21,10h01m20.487s,2d20m21.68s,412,260,152,39,2556,0
SNLS-04D2cc,2004-03-22,9h58m44.692s,2d16m14.53s,308,186,122,40,2543,357
SNLS-04D2cf,2004-03-21,10h01m56.09s,1d52m46.12s,138,90,48,39,2556,0
SNLS-04D2cw,2004-03-19,10h01m22.779s,2d11m54.81s,509,331,178,37,2558,1
SNLS-04D2fp,2004-04-13,9h59m28.12s,2d19m15.65s,426,266,160,62,2521,335
SNLS-04D2fs,2004-04-13,10h00m22.086s,1d45m55.43s,281,184,97,62,2521,335
SNLS-04D2gb,2004-04-20,10h02m22.668s,1d53m38.98s,163,90,73,69,2526,328
SNLS-04D2gc,2004-04-21,10h01m39.265s,1d52m58.99s,280,179,101,70,2525,327
SNLS-04D2kr,2004-12-14,10h00m37.342s,1d42m42.94s,332,184,148,307,2276,90
SNLS-04D2mh,2005-01-08,9h59m45.888s,2d08m27.69s,519,353,166,332,2251,65
SNLS-04D2mj,2005-01-08,10h00m36.531s,2d34m37.44s,314,180,134,332,2230,386
SNLS-04D3bf,2004-02-17,14h17m45.067s,52d28m04.05s,230,18,212,242,2662,35
SNLS-04D3co,2004-04-20,14h17m49.979s,52d57m49s,250,22,228,305,2599,61
SNLS-04D3dd,2004-04-25,14h17m48.405s,52d28m14.44s,233,22,211,310,2594,56
SNLS-04D3df,2004-04-20,14h18m10.001s,52d16m39.67s,37,2,35,298,2519,323
SNLS-04D3ez,2004-04-21,14h19m07.834s,53d04m19.01s,265,22,243,306,2598,60
SNLS-04D3gt,2004-05-22,14h22m32.591s,52d38m48.92s,234,22,212,337,2567,29
SNLS-04D3gx,2004-05-20,14h20m13.668s,52d16m58s,240,22,218,335,2569,31
SNLS-04D3is,2004-05-23,14h16m51.968s,52d48m45.7s,230,22,208,338,2566,28
SNLS-04D3lu,2004-06-22,14h21m07.97s,52d58m29.25s,234,25,209,368,2536,1
SNLS-04D3mk,2004-06-18,14h19m25.764s,53d09m49.3s,249,22,227,364,2540,2
SNLS-04D3ml,2004-06-19,14h16m39.068s,53d05m35.71s,50,1,49,87,2459,264
SNLS-04D3nh,2004-06-22,14h22m26.708s,52d20m00.41s,41,3,38,90,2536,1
SNLS-04D3nr,2004-07-14,14h22m38.508s,52d38m55.27s,234,26,208,390,2514,237
SNLS-04D3oe,2004-07-10,14h19m39.384s,52d33m13.85s,254,26,228,386,2518,241
SNLS-04D4an,2004-07-10,22h15m57.101s,-17d41m43.81s,208,46,162,314,1899,10
SNLS-04D4bk,2004-07-10,22h15m07.704s,-18d03m36.99s,208,46,162,314,1899,10
SNLS-04D4bq,2004-07-14,22h14m49.424s,-17d49m39.34s,210,46,164,318,1895,6
SNLS-04D4dw,2004-07-18,22h16m44.674s,-17d50m02.66s,199,46,153,322,1891,2
SNLS-04D4fx,2004-08-10,22h16m38.136s,-18d03m58.88s,199,56,143,345,1868,358
SNLS-04D4hf,2004-08-19,22h16m57.9s,-17d41m13.29s,201,56,145,354,1859,349
SNLS-04D4hu,2004-09-17,22h15m36.208s,-17d50m20.04s,210,56,154,383,1830,320
SNLS-04D4ib,2004-09-19,22h16m41.713s,-18d06m18.32s,199,56,143,385,1828,318
SNLS-04D4ic,2004-09-11,22h14m21.854s,-17d56m36.55s,210,56,154,377,1836,326
SNLS-04D4ih,2004-10-06,22h17m17.025s,-17d40m38.58s,21,2,19,381,1416,301
SNLS-04D4ii,2004-09-14,22h15m55.632s,-17d39m26.92s,208,56,152,380,1833,323
SNLS-04D4im,2004-10-09,22h15m00.846s,-17d23m45.75s,112,28,84,405,1808,298
SNLS-05D1az,2005-09-03,2h25m12.506s,-4d36m08.41s,310,148,162,676,1896,42
SNLS-05D1by,2005-09-02,2h24m35.437s,-4d12m04.02s,222,54,168,632,1897,43
SNLS-05D1cb,2005-09-10,2h26m57.056s,-4d07m03.24s,306,152,154,683,1889,35
SNLS-05D1cc,2005-09-04,2h26m31.168s,-4d09m53.28s,306,150,156,677,1895,41
SNLS-05D1cl,2005-09-25,2h25m05.655s,-4d13m14.95s,314,148,166,698,1874,20
SNLS-05D1dn,2005-09-27,2h24m26.65s,-4d59m29.61s,67,16,51,656,1872,18
SNLS-05D1ee,2005-10-30,2h24m46.749s,-4d00m01.75s,260,112,148,706,1839,4
SNLS-05D1ej,2005-10-26,2h26m06.349s,-4d43m46.13s,188,104,84,729,1843,8
SNLS-05D1em,2005-11-04,2h24m05.522s,-4d56m23.66s,101,23,78,694,1834,14
SNLS-05D1eo,2005-10-26,2h25m23.141s,-4d38m33.61s,293,194,99,729,1841,8
SNLS-05D1hk,2005-11-29,2h24m39.176s,-4d38m03.31s,360,220,140,763,1809,323
SNLS-05D1hm,2005-11-28,2h27m46.19s,-4d43m02s,121,94,27,762,1810,356
SNLS-05D1if,2005-11-30,2h24m29.72s,-4d34m13s,354,217,137,764,1808,322
SNLS-05D1ix,2005-11-29,2h24m19.967s,-4d40m12.01s,284,126,158,720,1809,323
SNLS-05D1iy,2005-11-29,2h27m39.961s,-4d25m21.29s,234,156,78,763,1809,344
SNLS-05D1iz,2005-12-03,2h26m12.768s,-4d46m24.13s,316,190,126,767,1805,319
SNLS-05D1ju,2005-12-26,2h26m57.297s,-4d08m02.74s,302,196,106,790,1782,296
SNLS-05D1ke,2005-12-29,2h26m46.292s,-4d51m44.98s,297,190,107,793,1779,293
SNLS-05D1kl,2005-12-30,2h24m33.539s,-4d19m08.26s,181,114,67,793,1778,292
SNLS-05D2ab,2005-01-08,10h01m50.846s,2d06m22.79s,303,178,125,332,2263,65
SNLS-05D2ac,2005-01-06,9h58m59.235s,2d29m22.21s,314,184,130,330,2253,67
SNLS-05D2ah,2005-01-08,10h01m28.728s,1d51m45.83s,286,184,102,332,2263,65
SNLS-05D2ay,2005-01-14,10h01m08.319s,2d07m49.16s,516,356,160,338,2257,59
SNLS-05D2bt,2005-02-01,10h01m40.244s,2d33m58.18s,283,130,153,356,2206,362
SNLS-05D2bv,2005-02-01,10h02m16.999s,2d14m26.16s,279,178,101,356,2239,41
SNLS-05D2bw,2005-02-01,9h58m30.558s,2d32m11.05s,152,50,102,356,2548,41
SNLS-05D2by,2005-02-12,10h00m28.032s,2d31m17.54s,311,180,131,367,2195,351
SNLS-05D2cb,2005-02-12,9h59m24.581s,2d19m41.45s,419,265,154,367,2216,30
SNLS-05D2ci,2005-03-09,10h00m02.041s,2d12m57.07s,522,356,166,392,2191,5
SNLS-05D2dw,2005-03-17,9h58m32.07s,2d01m56.07s,308,187,121,400,2183,318
SNLS-05D2eb,2005-03-15,10h00m14.564s,2d24m26.78s,525,352,173,398,2185,319
SNLS-05D2ec,2005-03-15,9h59m26.184s,2d00m49.05s,414,273,141,398,2185,319
SNLS-05D2ei,2005-04-12,10h01m39.116s,1d49m11.83s,263,143,120,426,2169,291
SNLS-05D2fq,2005-04-05,9h59m08.502s,2d36m07.2s,242,98,144,419,2143,299
SNLS-05D2hc,2005-05-10,10h00m04.593s,1d53m09.69s,288,187,101,454,2129,263
SNLS-05D2he,2005-04-12,10h01m26.511s,2d19m03.82s,408,269,139,426,2169,291
SNLS-05D2ie,2005-04-07,10h01m02.895s,2d39m29.11s,358,180,178,421,2141,297
SNLS-05D2ja,2005-05-06,10h00m03.804s,2d17m36.09s,530,357,173,450,2133,267
SNLS-05D2le,2005-12-01,10h01m54.86s,2d05m34.8s,305,179,126,659,1936,58
SNLS-05D2mp,2005-11-30,9h59m08.631s,2d12m14.42s,308,187,121,658,1925,60
SNLS-05D2my,2005-12-03,9h58m31.45s,2d29m28.4s,222,99,123,661,2243,57
SNLS-05D2nn,2005-12-06,9h58m49.751s,2d42m36.95s,208,90,118,664,2240,54
SNLS-05D2nt,2005-12-25,10h00m58.229s,2d22m21.83s,486,325,161,683,1879,34
SNLS-05D3ax,2005-02-10,14h19m17.583s,52d41m15.07s,254,26,228,601,2303,26
SNLS-05D3ci,2005-03-09,14h21m48.106s,52d26m43.01s,237,31,206,628,2276,0
SNLS-05D3cx,2005-04-09,14h21m06.542s,52d45m01.83s,237,100,137,659,2245,14
SNLS-05D3dd,2005-04-10,14h22m30.448s,52d36m24.46s,234,100,134,660,2244,13
SNLS-05D3gp,2005-04-10,14h22m42.316s,52d43m28.88s,234,100,134,660,2244,13
SNLS-05D3ha,2005-05-11,14h20m50.432s,52d50m02.53s,238,127,111,691,2213,24
SNLS-05D3ht,2005-05-11,14h17m54.701s,53d10m03.3s,233,126,107,691,2213,24
SNLS-05D3jb,2005-05-11,14h22m09.997s,52d52m41.27s,234,127,107,691,2213,24
SNLS-05D3jh,2005-05-12,14h17m25.384s,52d37m07.55s,234,127,107,692,2212,23
SNLS-05D3jk,2005-05-11,14h16m47.455s,52d35m32.96s,226,121,105,691,2213,24
SNLS-05D3jq,2005-06-03,14h21m45.441s,53d01m47.71s,233,127,106,714,2190,1
SNLS-05D3jr,2005-05-11,14h19m28.748s,52d51m53.45s,252,127,125,691,2213,24
SNLS-05D3km,2005-06-03,14h22m38.275s,53d04m01.2s,234,127,107,714,2190,1
SNLS-05D3kp,2005-06-08,14h20m02.944s,52d16m14.98s,227,134,93,719,2185,4
SNLS-05D3kt,2005-06-02,14h19m53.72s,52d44m34.75s,254,127,127,713,2191,2
SNLS-05D3kx,2005-06-08,14h21m50.019s,53d08m13.63s,233,141,92,719,2185,4
SNLS-05D3la,2005-06-08,14h21m25.418s,52d21m28.7s,236,141,95,719,2185,4
SNLS-05D3lb,2005-06-04,14h17m31.758s,53d10m04.54s,227,123,104,715,2189,0
SNLS-05D3lr,2005-06-08,14h22m12.142s,53d11m03.39s,233,141,92,719,2185,4
SNLS-05D3mh,2005-07-09,14h18m59.833s,52d40m03.21s,253,146,107,750,2154,237
SNLS-05D3mq,2005-08-02,14h19m00.428s,52d23m06.43s,234,146,88,774,2130,213
SNLS-05D3ne,2005-07-13,14h21m02.987s,52d29m43.58s,253,146,107,754,2150,233
SNLS-05D4af,2005-06-30,22h16m33.141s,-18d00m17.72s,199,56,143,669,1544,34
SNLS-05D4ag,2005-07-10,22h13m47.425s,-18d09m54.95s,207,56,151,679,1534,35
SNLS-05D4av,2005-07-09,22h14m10.544s,-17d54m43s,211,56,155,678,1535,25
SNLS-05D4ay,2005-07-01,22h14m33.191s,-17d46m03.62s,211,56,155,670,1543,33
SNLS-05D4bi,2005-07-06,22h15m56.55s,-17d59m09.85s,204,56,148,675,1538,28
SNLS-05D4bj,2005-07-09,22h14m59.664s,-18d08m00.26s,208,56,152,678,1535,25
SNLS-05D4bm,2005-07-10,22h17m04.611s,-17d40m39.44s,198,56,142,679,1534,24
SNLS-05D4cq,2005-08-02,22h14m09.65s,-18d13m36.17s,97,28,69,702,1116,12
SNLS-05D4cs,2005-08-02,22h17m17.818s,-17d52m48.54s,196,56,140,702,1511,1
SNLS-05D4cw,2005-08-06,22h14m50.08s,-17d44m19.56s,210,57,153,706,1507,8
SNLS-05D4dt,2005-09-01,22h14m25.847s,-17d40m16s,211,60,151,732,1481,4
SNLS-05D4dw,2005-09-08,22h16m55.878s,-18d03m05.26s,199,64,135,739,1474,1
SNLS-05D4dy,2005-09-05,22h15m30.119s,-18d12m55.81s,201,60,141,736,1477,2
SNLS-05D4ef,2005-09-22,22h13m59.305s,-18d12m44.44s,207,66,141,753,1460,10
SNLS-05D4ej,2005-09-25,22h15m52.517s,-18d11m44.59s,201,66,135,756,1457,7
SNLS-05D4ek,2005-09-24,22h16m27.517s,-17d44m10.74s,107,36,71,755,1458,8
SNLS-05D4ev,2005-09-10,22h13m30.424s,-17d42m02.83s,98,30,68,741,1077,22
SNLS-05D4fe,2005-09-25,22h15m40.268s,-17d31m42.38s,210,67,143,756,1457,7
SNLS-05D4ff,2005-09-28,22h16m20.16s,-18d02m33.2s,201,66,135,759,1454,4
SNLS-05D4fg,2005-09-27,22h16m41.348s,-17d35m43.66s,201,66,135,758,1455,5
SNLS-05D4gw,2005-11-04,22h14m47.356s,-17d31m54.84s,211,105,106,796,1417,269
SNLS-05D4hn,2005-11-30,22h17m13.564s,-17d54m45.74s,199,99,100,822,1391,243
SNLS-06D1ab,2006-01-05,2h24m59.031s,-4d40m51.2s,322,208,114,800,1772,286
SNLS-06D2ag,2006-01-25,10h01m43.36s,1d51m37.3s,210,125,85,714,1881,3
SNLS-06D2bk,2006-02-07,9h58m42.871s,2d10m19.14s,308,207,101,727,1856,3
SNLS-06D2ca,2006-02-26,9h59m09.557s,2d18m09.06s,316,213,103,746,1837,11
SNLS-06D2cb,2006-02-28,10h01m23.493s,2d27m22.35s,186,136,50,748,756,9
SNLS-06D2cc,2006-02-26,9h59m26.887s,2d27m04.88s,418,305,113,746,1837,11
SNLS-06D2cd,2006-03-02,10h00m57.961s,2d32m02.54s,313,210,103,750,1812,7
SNLS-06D2ce,2006-03-01,10h01m44.219s,2d42m47.93s,174,98,76,749,1813,17
SNLS-06D2ck,2006-03-07,10h01m28.016s,1d51m49.07s,286,201,85,755,1840,2
SNLS-06D2fb,2006-04-29,9h59m32.147s,1d49m40.52s,276,211,65,808,1775,266
SNLS-06D2ff,2006-04-27,10h00m16.345s,2d14m35.14s,526,423,103,806,1777,268
SNLS-06D2ga,2006-05-25,9h59m08.109s,1d56m18.58s,321,240,81,834,1749,240
SNLS-06D2gb,2006-05-28,10h00m47.419s,1d59m07.46s,388,313,75,837,1746,237
SNLS-06D3cb,2006-02-02,14h20m43.574s,52d11m27.83s,4,1,3,592,1543,1232
SNLS-06D3cc,2006-02-01,14h17m31.6s,52d54m44.9s,249,146,103,957,1947,30
SNLS-06D3cn,2006-03-05,14h19m25.848s,52d38m27.54s,254,158,96,989,1915,0
SNLS-06D3df,2006-04-30,14h22m17.209s,52d57m27.65s,234,185,49,1045,1859,37
SNLS-06D3dl,2006-04-27,14h22m12.577s,52d38m27.05s,234,185,49,1042,1862,40
SNLS-06D3dt,2006-05-04,14h17m21.664s,52d27m10.14s,227,178,49,1049,1855,33
SNLS-06D3ed,2006-05-25,14h18m47.802s,52d45m23.61s,251,185,66,1070,1834,12
SNLS-06D3en,2006-05-28,14h21m13.336s,52d27m21.88s,240,185,55,1073,1831,9
SNLS-06D3et,2006-05-30,14h22m04.77s,52d20m18.12s,212,165,47,1075,1829,7
SNLS-06D3fp,2006-06-17,14h20m18.605s,52d53m49.79s,251,187,64,1093,1811,293
SNLS-06D3gh,2006-06-29,14h18m31.419s,52d26m34.47s,234,187,47,1105,1799,281
SNLS-06D3gn,2006-07-05,14h17m44.63s,52d21m40.25s,222,175,47,1111,1793,275
SNLS-06D3gx,2006-07-26,14h17m03.234s,52d56m10.51s,248,186,62,1132,1772,254
SNLS-06D4ba,2006-07-03,22h15m35.72s,-18d13m44.7s,201,99,102,1037,1176,28
SNLS-06D4bo,2006-07-03,22h15m28.12s,-17d24m33.2s,206,104,102,1037,1176,28
SNLS-06D4bw,2006-07-02,22h15m03.7s,-17d53m00.2s,210,104,106,1036,1177,29
SNLS-06D4cl,2006-07-20,22h16m57.053s,-17d27m02.28s,9,3,6,351,434,71
SNLS-06D4cq,2006-07-29,22h16m55.523s,-17d42m43.13s,201,101,100,1063,1150,2
SNLS-06D4dh,2006-07-29,22h14m19.693s,-17d35m06.03s,211,105,106,1063,1150,2
Shaya,2006-04-22,14h29m18.743s,34d38m37.38s,4,1,3,7,1066,373
Spock,2005-01-06,12h37m06.53s,62d15m11.7s,82,44,38,346,1230,413
Strolger,2005-04-14,12h36m46.879s,62d11m45.21s,213,121,92,444,2155,3
Tomo,2006-01-16,14h38m08.366s,34d14m18.08s,5,1,4,592,1162,469
Yowie,2004-05-19,12h36m34.363s,62d12m12.55s,213,121,92,114,2485,333
Zwicky,2005-02-01,3h32m45.65s,-27d44m24.3s,326,78,248,449,2136,263
